Επίπεδο διοικητικής διαίρεσης,DHMOSID,Περιγραφή,Σύνολο,Σύνολο οικονομικών ενεργών,Σύνολο απασχολούμενων,Πρωτογενής Τομέας,Δευτερογενής Τομέας,Τριτογενής Τομέας,Ανεργοι,Οικονομικά μη ενεργοί,A_pct,B_pct,C_pct,unempl_pct
3,110101,ΔΗΜΟΣ ΚΟΜΟΤΗΝΗΣ,66919,25386,20631,2879,3187,14565,4755,41533,13.954728321458001,15.447627356890116,70.59764432165188,18.73079650200898
3,110102,ΔΗΜΟΣ ΑΡΡΙΑΝΩΝ,16577,7232,6658,5532,368,758,574,9345,83.08801441874436,5.527185340943226,11.384800240312407,7.936946902654867
3,110103,ΔΗΜΟΣ ΙΑΣΜΟΥ,13810,5377,4505,2695,661,1149,872,8433,59.822419533851274,14.672586015538291,25.504994450610432,16.217221498977125
3,110104,ΔΗΜΟΣ ΜΑΡΩΝΕΙΑΣ - ΣΑΠΩΝ,14733,5018,4004,2074,674,1256,1014,9715,51.798201798201795,16.833166833166832,31.36863136863137,20.207253886010363
3,110201,ΔΗΜΟΣ ΔΡΑΜΑΣ,58944,23530,18021,1308,3527,13186,5509,35414,7.258198768103878,19.571610898396315,73.1701903334998,23.412664683382914
3,110202,ΔΗΜΟΣ ΔΟΞΑΤΟΥ,14516,5192,3810,890,803,2117,1382,9324,23.35958005249344,21.076115485564305,55.56430446194226,26.61787365177196
3,110203,ΔΗΜΟΣ ΚΑΤΩ ΝΕΥΡΟΚΟΠΙΟΥ,7860,2687,2150,1111,288,751,537,5173,51.674418604651166,13.395348837209303,34.93023255813954,19.985113509490137
3,110204,ΔΗΜΟΣ ΠΑΡΑΝΕΣΤΙΟΥ,3901,1088,808,271,147,390,280,2813,33.539603960396036,18.193069306930692,48.26732673267327,25.735294117647058
3,110205,ΔΗΜΟΣ ΠΡΟΣΟΤΣΑΝΗΣ,13066,4223,3231,978,706,1547,992,8843,30.269266480965644,21.850820179510986,47.87991333952337,23.490409661378166
3,110301,ΔΗΜΟΣ ΑΛΕΞΑΝΔΡΟΥΠΟΛΗΣ,72959,30219,25044,1897,3198,19949,5175,42740,7.574668583293404,12.769525634882607,79.65580578182399,17.124987590588702
3,110302,ΔΗΜΟΣ ΔΙΔΥΜΟΤΕΙΧΟΥ,19493,6308,5334,1265,514,3555,974,13185,23.71578552680915,9.636295463067116,66.64791901012373,15.440710209258086
3,110303,ΔΗΜΟΣ ΟΡΕΣΤΙΑΔΑΣ,37695,14599,12657,3348,1251,8058,1942,23096,26.451765821284663,9.883858734297227,63.664375444418106,13.302280978149188
3,110305,ΔΗΜΟΣ ΣΟΥΦΛΙΟΥ,14941,5127,4471,1598,502,2371,656,9814,35.741444866920155,11.227913218519348,53.0306419145605,12.795006826604252
3,110401,ΔΗΜΟΣ ΘΑΣΟΥ,13770,5468,4478,648,854,2976,990,8302,14.47074586869138,19.071013845466727,66.4582402858419,18.105340160936358
3,110501,ΔΗΜΟΣ ΚΑΒΑΛΑΣ,70501,28020,22033,1185,4084,16764,5987,42481,5.378296192075523,18.53583261471429,76.08587119321018,21.36688079942898
3,110502,ΔΗΜΟΣ ΝΕΣΤΟΥ,22331,8672,7060,2078,1362,3620,1612,13659,29.43342776203966,19.291784702549574,51.274787535410766,18.588560885608857
3,110503,ΔΗΜΟΣ ΠΑΓΓΑΙΟΥ,32085,12090,9849,3173,1868,4808,2241,19995,32.216468677023045,18.966392527160117,48.81713879581683,18.535980148883375
3,110601,ΔΗΜΟΣ ΞΑΝΘΗΣ,65133,26796,19989,830,3801,15358,6807,38337,4.152283756065836,19.015458502176198,76.83225774175797,25.403045230631438
3,110602,ΔΗΜΟΣ ΑΒΔΗΡΩΝ,19005,7130,5014,1640,1229,2145,2116,11875,32.708416433984844,24.511368169126445,42.780215396888714,29.677419354838708
3,110603,ΔΗΜΟΣ ΜΥΚΗΣ,15540,5395,3616,1743,1195,678,1779,10145,48.20243362831859,33.04756637168141,18.75,32.97497683039852
3,110604,ΔΗΜΟΣ ΤΟΠΕΙΡΟΥ,11544,3938,3006,1440,560,1006,932,7606,47.90419161676647,18.629407850964736,33.46640053226879,23.66683595733875
3,120701,ΔΗΜΟΣ ΘΕΣΣΑΛΟΝΙΚΗΣ,325182,134572,103243,877,15367,86999,31329,190610,0.8494522631074262,14.884302083434228,84.26624565345834,23.280474392890053
3,120702,ΔΗΜΟΣ ΑΜΠΕΛΟΚΗΠΩΝ - ΜΕΝΕΜΕΝΗΣ,52127,22258,15498,161,3691,11646,6760,29869,1.038843721770551,23.815976255000646,75.1451800232288,30.371102524934855
3,120703,ΔΗΜΟΣ ΒΟΛΒΗΣ,23478,7602,6005,1695,1080,3230,1597,15876,28.22647793505412,17.985012489592005,53.78850957535387,21.007629571165484
3,120704,ΔΗΜΟΣ ΔΕΛΤΑ,45839,18791,14263,1830,4588,7845,4528,27048,12.83040033653509,32.1671457617612,55.00245390170371,24.09664200947262
3,120705,ΔΗΜΟΣ ΘΕΡΜΑΪΚΟΥ,50264,20747,16435,1160,2746,12529,4312,29517,7.058107696988135,16.708244599939153,76.2336477030727,20.783727767870054
3,120706,ΔΗΜΟΣ ΘΕΡΜΗΣ,53201,23203,19743,1040,3393,15310,3460,29998,5.26768981411133,17.185838018538217,77.54647216735046,14.911864845063139
3,120707,ΔΗΜΟΣ ΚΑΛΑΜΑΡΙΑΣ,91518,41998,34420,387,4555,29478,7578,49520,1.1243463102847182,13.233585124927368,85.64206856478792,18.04371636744607
3,120708,ΔΗΜΟΣ ΚΟΡΔΕΛΙΟΥ - ΕΥΟΣΜΟΥ,101753,48078,36421,352,8900,27169,11657,53675,0.9664753850800363,24.43645149776228,74.59707311715768,24.246016889221682
3,120709,ΔΗΜΟΣ ΛΑΓΚΑΔΑ,41103,15030,11589,1882,2831,6876,3441,26073,16.239537492449738,24.428337216325826,59.332125291224436,22.894211576846306
3,120710,ΔΗΜΟΣ ΝΕΑΠΟΛΗΣ - ΣΥΚΕΩΝ,84741,37409,28301,227,5644,22430,9108,47332,0.8020917988763648,19.9427582064238,79.25514999469983,24.347082252933784
3,120711,ΔΗΜΟΣ ΠΑΥΛΟΥ ΜΕΛΑ,99245,45000,32621,343,7959,24319,12379,54245,1.0514699120198645,24.398393672787467,74.55013641519267,27.50888888888889
3,120712,ΔΗΜΟΣ ΠΥΛΑΙΑΣ - ΧΟΡΤΙΑΤΗ,70110,31980,27334,258,4209,22867,4646,38130,0.9438794175751811,15.398404916953245,83.65771566547157,14.527829893683553
3,120713,ΔΗΜΟΣ ΧΑΛΚΗΔΟΝΟΣ,33673,13150,10162,1705,2989,5468,2988,20523,16.778193269041527,29.41350127927573,53.80830545168274,22.722433460076047
3,120714,ΔΗΜΟΣ ΩΡΑΙΟΚΑΣΤΡΟΥ,38317,16373,13357,555,3195,9607,3016,21944,4.1551246537396125,23.92004192558209,71.9248334206783,18.420570451352837
3,120801,ΔΗΜΟΣ ΒΕΡΟΙΑΣ,66547,27275,21275,3689,3672,13914,6000,39272,17.339600470035254,17.25969447708578,65.40070505287896,21.998166819431713
3,120802,ΔΗΜΟΣ ΑΛΕΞΑΝΔΡΕΙΑΣ,41570,15801,12054,4201,2365,5488,3747,25769,34.85150157624025,19.620043139206903,45.52845528455285,23.713689007024872
3,120803,ΔΗΜΟΣ ΝΑΟΥΣΑΣ,32494,12700,9774,2990,1704,5080,2926,19794,30.59136484550849,17.43400859422959,51.97462656026192,23.03937007874016
3,120901,ΔΗΜΟΣ ΚΙΛΚΙΣ,51926,19734,15439,2336,4150,8953,4295,32192,15.13051363430274,26.879979273268994,57.98950709242827,21.76446741664133
3,120902,ΔΗΜΟΣ ΠΑΙΟΝΙΑΣ,28493,9839,7547,1807,1735,4005,2292,18654,23.94328872399629,22.989267258513316,53.067444017490395,23.295050309990852
3,121001,ΔΗΜΟΣ ΕΔΕΣΣΑΣ,28814,11230,9191,2387,1337,5467,2039,17584,25.97105864432597,14.546839299314547,59.48210205635948,18.15672306322351
3,121002,ΔΗΜΟΣ ΑΛΜΩΠΙΑΣ,27556,10205,8505,3904,971,3630,1700,17351,45.90241034685479,11.416813639035862,42.68077601410935,16.658500734933856
3,121003,ΔΗΜΟΣ ΠΕΛΛΑΣ,63122,25312,19917,5494,3605,10818,5395,37810,27.584475573630566,18.10011547923884,54.31540894713059,21.314001264222505
3,121004,ΔΗΜΟΣ ΣΚΥΔΡΑΣ,20188,7835,6190,2578,1136,2476,1645,12353,41.647819063004846,18.352180936995154,40.0,20.995532865347798
3,121101,ΔΗΜΟΣ ΚΑΤΕΡΙΝΗΣ,85851,34848,27504,4244,4487,18773,7344,51003,15.430482838859803,16.313990692262944,68.25552646887725,21.074380165289256
3,121102,ΔΗΜΟΣ ΔΙΟΥ - ΟΛΥΜΠΟΥ,25668,9270,7558,1901,1346,4311,1712,16398,25.15215665519979,17.808944165123048,57.038899179677166,18.468176914778855
3,121103,ΔΗΜΟΣ ΠΥΔΝΑΣ - ΚΟΛΙΝΔΡΟΥ,15179,5333,4362,1697,749,1916,971,9846,38.90417239798258,17.171022466758366,43.92480513525906,18.20738796174761
3,121201,ΔΗΜΟΣ ΣΕΡΡΩΝ,76817,30106,24078,2743,3722,17613,6028,46711,11.392142204502035,15.458094526123432,73.14976326937453,20.022586859762175
3,121202,ΔΗΜΟΣ ΑΜΦΙΠΟΛΗΣ,9182,2675,2080,916,237,927,595,6507,44.03846153846154,11.39423076923077,44.56730769230769,22.242990654205606
3,121203,ΔΗΜΟΣ ΒΙΣΑΛΤΙΑΣ,20030,6795,5580,2740,758,2082,1215,13235,49.10394265232975,13.584229390681003,37.31182795698925,17.880794701986755
3,121204,ΔΗΜΟΣ ΕΜΜΑΝΟΥΗΛ ΠΑΠΠΑ,14664,4969,3946,1499,726,1721,1023,9695,37.98783578307147,18.398378104409527,43.61378611251901,20.587643389011873
3,121205,ΔΗΜΟΣ ΗΡΑΚΛΕΙΑΣ,21145,7220,5434,2437,722,2275,1786,13925,44.84725800515274,13.286713286713287,41.866028708133975,24.736842105263158
3,121206,ΔΗΜΟΣ ΝΕΑΣ ΖΙΧΝΗΣ,12397,4246,3611,1953,356,1302,635,8151,54.08474106895597,9.858764885073386,36.056494045970645,14.955252001884126
3,121207,ΔΗΜΟΣ ΣΙΝΤΙΚΗΣ,22195,7046,5247,1863,718,2666,1799,15149,35.506003430531734,13.684009910425004,50.80998665904326,25.532216860630143
3,121301,ΔΗΜΟΣ ΠΟΛΥΓΥΡΟΥ,22048,8764,7394,1683,1444,4267,1370,13284,22.76169867460103,19.529348120097378,57.7089532053016,15.632131446827932
3,121303,ΔΗΜΟΣ ΚΑΣΣΑΝΔΡΑΣ,16672,7309,5825,522,1035,4268,1484,9363,8.96137339055794,17.76824034334764,73.27038626609442,20.303735121083594
3,121304,ΔΗΜΟΣ ΝΕΑΣ ΠΡΟΠΟΝΤΙΔΑΣ,36500,14804,11763,2268,2508,6987,3041,21696,19.28079571537873,21.32109155827595,59.39811272634532,20.541745474196162
3,121305,ΔΗΜΟΣ ΣΙΘΩΝΙΑΣ,12394,5205,4162,665,628,2869,1043,7189,15.977895242671792,15.088899567515618,68.9332051898126,20.038424591738714
3,211401,ΔΗΜΟΣ ΚΟΖΑΝΗΣ,71388,28015,21631,1103,6138,14390,6384,43373,5.099163237945541,28.37594193518561,66.52489482686885,22.78779225414956
3,211402,ΔΗΜΟΣ ΒΟΪΟΥ,18386,6474,4815,1030,1360,2425,1659,11912,21.391484942886812,28.245067497403944,50.36344755970924,25.625579240037073
3,211403,ΔΗΜΟΣ ΕΟΡΔΑΙΑΣ,45592,16931,13318,718,4970,7630,3613,28661,5.3911998798618415,37.31791560294339,57.290884517194776,21.33955466304412
3,211404,ΔΗΜΟΣ ΣΕΡΒΙΩΝ - ΒΕΛΒΕΝΤΟΥ,14830,4933,3732,982,904,1846,1201,9897,26.312968917470524,24.222936763129688,49.464094319399784,24.34623961078451
3,211501,ΔΗΜΟΣ ΓΡΕΒΕΝΩΝ,25905,8860,7140,1298,1239,4603,1720,17045,18.179271708683473,17.352941176470587,64.46778711484593,19.41309255079007
3,211502,ΔΗΜΟΣ ΔΕΣΚΑΤΗΣ,5852,1975,1533,594,193,746,442,3877,38.74755381604697,12.58969341161122,48.66275277234181,22.379746835443036
3,211601,ΔΗΜΟΣ ΚΑΣΤΟΡΙΑΣ,35874,15412,11573,2057,2492,7024,3839,20462,17.774129439211958,21.532878251101703,60.69299230968634,24.909161692187904
3,211602,ΔΗΜΟΣ ΝΕΣΤΟΡΙΟΥ,2646,968,691,221,136,334,277,1678,31.98263386396527,19.68162083936324,48.33574529667149,28.615702479338843
3,211603,ΔΗΜΟΣ ΟΡΕΣΤΙΔΟΣ,11802,4886,3743,749,816,2178,1143,6916,20.010686615014695,21.800694629975954,58.18861875500935,23.39336880884159
3,211701,ΔΗΜΟΣ ΦΛΩΡΙΝΑΣ,32881,12767,9960,1429,2075,6456,2807,20114,14.347389558232932,20.833333333333332,64.81927710843374,21.98637111302577
3,211702,ΔΗΜΟΣ ΑΜΥΝΤΑΙΟΥ,16973,6248,4853,1280,1349,2224,1395,10725,26.375437873480323,27.79723882134762,45.82732330517206,22.327144686299615
3,211703,ΔΗΜΟΣ ΠΡΕΣΠΩΝ,1560,625,541,331,25,185,84,935,61.182994454713494,4.621072088724584,34.195933456561924,13.44
3,221801,ΔΗΜΟΣ ΙΩΑΝΝΙΤΩΝ,112486,47545,39287,1676,7091,30520,8258,64941,4.266042202255199,18.049227479827934,77.68473031791687,17.368808497213166
3,221802,ΔΗΜΟΣ ΒΟΡΕΙΩΝ ΤΖΟΥΜΕΡΚΩΝ,5714,1751,1518,273,346,899,233,3963,17.984189723320156,22.793148880105402,59.22266139657444,13.306681896059395
3,221803,ΔΗΜΟΣ ΔΩΔΩΝΗΣ,9693,3005,2490,591,502,1397,515,6688,23.734939759036145,20.160642570281123,56.10441767068273,17.13810316139767
3,221804,ΔΗΜΟΣ ΖΑΓΟΡΙΟΥ,3724,1312,1147,357,185,605,165,2412,31.12467306015693,16.129032258064516,52.74629468177855,12.576219512195122
3,221805,ΔΗΜΟΣ ΖΙΤΣΑΣ,14766,5845,4704,799,1126,2779,1141,8921,16.985544217687075,23.937074829931973,59.07738095238095,19.520958083832337
3,221806,ΔΗΜΟΣ ΚΟΝΙΤΣΑΣ,6362,2031,1684,346,358,980,347,4331,20.546318289786225,21.258907363420427,58.19477434679335,17.085179714426392
3,221807,ΔΗΜΟΣ ΜΕΤΣΟΒΟΥ,6196,2107,1686,384,440,862,421,4089,22.775800711743774,26.097271648873072,51.126927639383155,19.981015662078786
3,221808,ΔΗΜΟΣ ΠΩΓΩΝΙΟΥ,8960,2766,2138,620,458,1060,628,6194,28.999064546304957,21.421889616463986,49.57904583723106,22.704266088214027
3,221901,ΔΗΜΟΣ ΑΡΤΑΙΩΝ,43166,16782,13584,2245,2362,8977,3198,26384,16.526796230859834,17.388103651354534,66.08510011778563,19.056131569538792
3,221902,ΔΗΜΟΣ ΓΕΩΡΓΙΟΥ ΚΑΡΑΪΣΚΑΚΗ,5780,1578,1216,498,194,524,362,4202,40.953947368421055,15.953947368421053,43.0921052631579,22.9404309252218
3,221903,ΔΗΜΟΣ ΚΕΝΤΡΙΚΩΝ ΤΖΟΥΜΕΡΚΩΝ,6178,1448,1149,339,302,508,299,4730,29.503916449086162,26.28372497824195,44.21235857267189,20.64917127071823
3,221904,ΔΗΜΟΣ ΝΙΚΟΛΑΟΥ ΣΚΟΥΦΑ,12753,4333,3489,1186,564,1739,844,8420,33.992548008025224,16.165090283748924,49.84236170822585,19.47842141703208
3,222001,ΔΗΜΟΣ ΗΓΟΥΜΕΝΙΤΣΑΣ,25814,10890,8774,1028,1323,6423,2116,14924,11.716434921358559,15.078641440620014,73.20492363802143,19.43067033976125
3,222002,ΔΗΜΟΣ ΣΟΥΛΙΟΥ,10063,3649,2979,894,520,1565,670,6414,30.01007049345418,17.45552198724404,52.53440751930178,18.361194847903537
3,222003,ΔΗΜΟΣ ΦΙΛΙΑΤΩΝ,7710,2700,2230,942,293,995,470,5010,42.24215246636771,13.139013452914797,44.61883408071749,17.40740740740741
3,222101,ΔΗΜΟΣ ΠΡΕΒΕΖΑΣ,31733,12717,10509,1773,1591,7145,2208,19016,16.87125321153297,15.139404320106575,67.98934246836045,17.36258551545176
3,222102,ΔΗΜΟΣ ΖΗΡΟΥ,13892,4725,3707,859,708,2140,1018,9167,23.172376584839494,19.099001888319396,57.72862152684111,21.544973544973544
3,222103,ΔΗΜΟΣ ΠΑΡΓΑΣ,11866,4528,3762,1192,498,2072,766,7338,31.68527379053695,13.237639553429027,55.07708665603403,16.91696113074205
3,312201,ΔΗΜΟΣ ΛΑΡΙΣΑΙΩΝ,162591,68899,56186,3077,9698,43411,12713,93692,5.476453208984444,17.260527533549283,77.26301925746627,18.451646613158392
3,312202,ΔΗΜΟΣ ΑΓΙΑΣ,11470,3883,3346,1543,406,1397,537,7587,46.11476389719068,12.133891213389122,41.7513448894202,13.829513262941026
3,312203,ΔΗΜΟΣ ΕΛΑΣΣΟΝΑΣ,32121,10902,9066,3686,1392,3988,1836,21219,40.65740127950585,15.354070152217075,43.988528568277076,16.840946615299945
3,312204,ΔΗΜΟΣ ΚΙΛΕΛΕΡ,20854,7996,6690,2525,998,3167,1306,12858,37.742899850523166,14.91778774289985,47.33931240657698,16.333166583291646
3,312205,ΔΗΜΟΣ ΤΕΜΠΩΝ,13712,4508,3751,1184,820,1747,757,9204,31.56491602239403,21.860837110103972,46.574246867502,16.792369121561666
3,312206,ΔΗΜΟΣ ΤΥΡΝΑΒΟΥ,25032,9743,8185,2855,1449,3881,1558,15289,34.88087965791081,17.703115455100793,47.4160048869884,15.990967874371343
3,312207,ΔΗΜΟΣ ΦΑΡΣΑΛΩΝ,18545,6591,5489,2352,799,2338,1102,11954,42.849335033703774,14.556385498269266,42.59427946802696,16.719769382491275
3,312301,ΔΗΜΟΣ ΚΑΡΔΙΤΣΑΣ,56747,22536,17889,2242,2805,12842,4647,34211,12.532841410922913,15.680026832131478,71.78713175694561,20.62034078807242
3,312302,ΔΗΜΟΣ ΑΡΓΙΘΕΑΣ,3450,802,572,206,123,243,230,2648,36.01398601398601,21.503496503496503,42.48251748251748,28.678304239401495
3,312303,ΔΗΜΟΣ ΛΙΜΝΗΣ ΠΛΑΣΤΗΡΑ,4635,1156,956,220,175,561,200,3479,23.01255230125523,18.305439330543933,58.68200836820084,17.301038062283737
3,312304,ΔΗΜΟΣ ΜΟΥΖΑΚΙΟΥ,13122,4230,3322,1244,520,1558,908,8892,37.4473208910295,15.653220951234196,46.899458157736305,21.465721040189127
3,312305,ΔΗΜΟΣ ΠΑΛΑΜΑ,16726,6455,5492,3076,499,1917,963,10271,56.00873998543336,9.085943190094683,34.90531682447196,14.918667699457785
3,312306,ΔΗΜΟΣ ΣΟΦΑΔΩΝ,18864,6242,4793,2524,474,1795,1449,12622,52.66012935530983,9.889422073857709,37.450448570832464,23.213713553348285
3,312401,ΔΗΜΟΣ ΒΟΛΟΥ,144449,57685,46119,2167,9700,34252,11566,86764,4.698714195884559,21.03254623907717,74.26873956503827,20.050273034584382
3,312402,ΔΗΜΟΣ ΑΛΜΥΡΟΥ,18614,6891,5801,1748,1143,2910,1090,11723,30.132735735218066,19.703499396655747,50.16376486812619,15.817733275286606
3,312403,ΔΗΜΟΣ ΖΑΓΟΡΑΣ - ΜΟΥΡΕΣΙΟΥ,5809,2271,2047,1052,269,726,224,3538,51.39228138739619,13.141182217879825,35.46653639472399,9.863496257155438
3,312404,ΔΗΜΟΣ ΝΟΤΙΟΥ ΠΗΛΙΟΥ,10216,3592,3080,1160,540,1380,512,6624,37.66233766233766,17.532467532467532,44.8051948051948,14.25389755011136
3,312405,ΔΗΜΟΣ ΡΗΓΑ ΦΕΡΑΙΟΥ,10922,4087,3297,1109,661,1527,790,6835,33.63663936912344,20.04852896572642,46.31483166515014,19.32958160019574
3,312501,ΔΗΜΟΣ ΣΚΙΑΘΟΥ,6088,2984,2551,74,358,2119,433,3104,2.9008232065856525,14.033712269698158,83.06546452371619,14.510723860589811
3,312502,ΔΗΜΟΣ ΑΛΟΝΝΗΣΟΥ,2750,973,791,98,193,500,182,1777,12.389380530973451,24.399494310998737,63.21112515802781,18.705035971223023
3,312503,ΔΗΜΟΣ ΣΚΟΠΕΛΟΥ,4960,1879,1600,143,339,1118,279,3081,8.9375,21.1875,69.875,14.84832357637041
3,312601,ΔΗΜΟΣ ΤΡΙΚΚΑΙΩΝ,81355,32323,25972,3127,4496,18349,6351,49032,12.039889111350686,17.31095025411982,70.6491606345295,19.64854747393497
3,312602,ΔΗΜΟΣ ΚΑΛΑΜΠΑΚΑΣ,21991,7217,5754,1570,1061,3123,1463,14774,27.285366701425097,18.439346541536324,54.27528675703858,20.271580989330747
3,312603,ΔΗΜΟΣ ΠΥΛΗΣ,14343,4882,3743,1100,751,1892,1139,9461,29.388191290408763,20.064119690088166,50.547689019503075,23.330602212208113
3,312604,ΔΗΜΟΣ ΦΑΡΚΑΔΟΝΑΣ,13396,4700,3913,1872,682,1359,787,8696,47.840531561461795,17.429082545361616,34.73038589317659,16.74468085106383
3,322701,ΔΗΜΟΣ ΛΑΜΙΕΩΝ,75315,30266,24326,2267,4562,17497,5940,45049,9.31924689632492,18.75359697443065,71.92715612924442,19.625982951166325
3,322702,ΔΗΜΟΣ ΑΜΦΙΚΛΕΙΑΣ - ΕΛΑΤΕΙΑΣ,10922,4071,3408,1246,521,1641,663,6851,36.56103286384977,15.28755868544601,48.151408450704224,16.28592483419307
3,322703,ΔΗΜΟΣ ΔΟΜΟΚΟΥ,11495,4158,3673,1807,433,1433,485,7337,49.19684181867683,11.788728559760413,39.014429621562755,11.664261664261664
3,322704,ΔΗΜΟΣ ΛΟΚΡΩΝ,19623,7440,6297,1736,1699,2862,1143,12183,27.568683500079402,26.981102112116883,45.45021438780372,15.362903225806452
3,322705,ΔΗΜΟΣ ΜΑΚΡΑΚΩΜΗΣ,16036,5245,3988,976,785,2227,1257,10791,24.473420260782348,19.68405215646941,55.84252758274825,23.96568160152526
3,322706,ΔΗΜΟΣ ΜΩΛΟΥ - ΑΓΙΟΥ ΚΩΝΣΤΑΝΤΙΝΟΥ,12090,4479,3655,1023,593,2039,824,7611,27.9890560875513,16.22435020519836,55.78659370725034,18.3969636079482
3,322707,ΔΗΜΟΣ ΣΤΥΛΙΔΟΣ,12750,4876,3975,1334,725,1916,901,7874,33.55974842767296,18.238993710691823,48.20125786163522,18.47826086956522
3,322801,ΔΗΜΟΣ ΛΕΒΑΔΕΩΝ,31315,13088,10673,1259,2539,6875,2415,18227,11.796121053124708,23.78900028108311,64.41487866579219,18.452017114914426
3,322802,ΔΗΜΟΣ ΑΛΙΑΡΤΟΥ,10887,4711,3706,1046,934,1726,1005,6176,28.22450080949811,25.20237452779277,46.57312466270912,21.333050307790277
3,322803,ΔΗΜΟΣ ΔΙΣΤΟΜΟΥ - ΑΡΑΧΟΒΑΣ - ΑΝΤΙΚΥΡΑΣ,8188,3269,2693,151,1083,1459,576,4919,5.607129595246937,40.215373189751205,54.17749721500186,17.620067298868154
3,322804,ΔΗΜΟΣ ΘΗΒΑΙΩΝ,36477,16356,13695,3519,3513,6663,2661,20121,25.695509309967143,25.65169769989047,48.65279299014239,16.26925898752751
3,322805,ΔΗΜΟΣ ΟΡΧΟΜΕΝΟΥ,11621,4540,3691,1586,685,1420,849,7081,42.969384990517476,18.55865619073422,38.471958818748305,18.70044052863436
3,322806,ΔΗΜΟΣ ΤΑΝΑΓΡΑΣ,19432,9074,7627,1406,2980,3241,1447,10358,18.43450898125082,39.071718893405006,42.49377212534417,15.946660789067666
3,322901,ΔΗΜΟΣ ΧΑΛΚΙΔΕΩΝ,102223,45268,36391,2499,10367,23525,8877,56955,6.867082520403397,28.487812920777117,64.64510455881948,19.60987894318282
3,322902,ΔΗΜΟΣ ΔΙΡΦΥΩΝ - ΜΕΣΣΑΠΙΩΝ,18800,7523,6067,1600,1700,2767,1456,11277,26.3721773528927,28.02043843744849,45.60738420965881,19.353981124551375
3,322903,ΔΗΜΟΣ ΕΡΕΤΡΙΑΣ,13053,5032,3877,364,1080,2433,1155,8021,9.388702605107042,27.856590147020892,62.75470724787207,22.95310015898251
3,322904,ΔΗΜΟΣ ΙΣΤΙΑΙΑΣ - ΑΙΔΗΨΟΥ,21083,7739,6242,1440,1085,3717,1497,13344,23.069528997116308,17.382249279077218,59.54822172380647,19.343584442434423
3,322905,ΔΗΜΟΣ ΚΑΡΥΣΤΟΥ,12180,4358,3605,759,815,2031,753,7822,21.054091539528432,22.60748959778086,56.33841886269071,17.278568150527764
3,322906,ΔΗΜΟΣ ΚΥΜΗΣ - ΑΛΙΒΕΡΙΟΥ,28437,9432,7722,974,2305,4443,1710,19005,12.613312613312614,29.84977984977985,57.536907536907535,18.129770992366414
3,322907,ΔΗΜΟΣ ΜΑΝΤΟΥΔΙΟΥ - ΛΙΜΝΗΣ - ΑΓΙΑΣ ΑΝΝΑΣ,12045,4237,3032,602,709,1721,1205,7808,19.854881266490764,23.383905013192614,56.761213720316626,28.439933915506256
3,322908,ΔΗΜΟΣ ΣΚΥΡΟΥ,2994,1202,1054,135,166,753,148,1792,12.808349146110057,15.749525616698293,71.44212523719165,12.312811980033278
3,323001,ΔΗΜΟΣ ΚΑΡΠΕΝΗΣΙΟΥ,13105,4760,3715,467,661,2587,1045,8345,12.570659488559892,17.792732166890982,69.63660834454913,21.95378151260504
3,323002,ΔΗΜΟΣ ΑΓΡΑΦΩΝ,6976,1941,1396,614,243,539,545,5035,43.98280802292263,17.406876790830946,38.61031518624642,28.07831014940752
3,323101,ΔΗΜΟΣ ΔΕΛΦΩΝ,26716,10273,8378,1016,1675,5687,1895,16443,12.126999283838625,19.9928383862497,67.88016232991167,18.44641292709043
3,323102,ΔΗΜΟΣ ΔΩΡΙΔΟΣ,13627,3940,3086,669,605,1812,854,9687,21.678548282566428,19.604666234607908,58.716785482825664,21.6751269035533
3,413201,ΔΗΜΟΣ ΚΕΡΚΥΡΑΣ,102071,43773,35594,2374,4655,28565,8179,58298,6.6696634264201835,13.078046861830646,80.25228971174917,18.6850341534736
3,413202,ΔΗΜΟΣ ΠΑΞΩΝ,2300,989,883,136,132,615,106,1311,15.402038505096263,14.949037372593432,69.6489241223103,10.717896865520729
3,413301,ΔΗΜΟΣ ΖΑΚΥΝΘΟΥ,40759,18271,15206,2158,1911,11137,3065,22488,14.191766407996843,12.567407602262264,73.2408259897409,16.775217557878605
3,413401,ΔΗΜΟΣ ΙΘΑΚΗΣ,3231,1233,1081,122,234,725,152,1998,11.285846438482887,21.646623496762256,67.06753006475486,12.327656123276562
3,413501,ΔΗΜΟΣ ΚΕΦΑΛΟΝΙΑΣ,35801,14762,12445,1303,2158,8984,2317,21039,10.470068300522298,17.340297308155886,72.18963439132182,15.695705188998781
3,413601,ΔΗΜΟΣ ΛΕΥΚΑΔΑΣ,22652,9346,7863,770,1447,5646,1483,13306,9.792699987282209,18.402645300775784,71.804654711942,15.867750909479991
3,413602,ΔΗΜΟΣ ΜΕΓΑΝΗΣΙΟΥ,1041,319,278,35,37,206,41,722,12.589928057553957,13.309352517985612,74.10071942446044,12.852664576802507
3,423701,ΔΗΜΟΣ ΠΑΤΡΕΩΝ,213984,87763,68820,1477,11899,55444,18943,126221,2.146178436501017,17.290031967451323,80.56378959604766,21.584266718320933
3,423702,ΔΗΜΟΣ ΑΙΓΙΑΛΕΙΑΣ,49872,19398,15515,3107,2941,9467,3883,30474,20.025781501772478,18.95584917821463,61.018369320012894,20.017527580162902
3,423703,ΔΗΜΟΣ ΔΥΤΙΚΗΣ ΑΧΑΪΑΣ,25916,8956,7033,2340,1145,3548,1923,16960,33.271719038817004,16.280392435660456,50.447888525522536,21.4716391246092
3,423704,ΔΗΜΟΣ ΕΡΥΜΑΝΘΟΥ,8877,3194,2625,1130,438,1057,569,5683,43.04761904761905,16.685714285714287,40.266666666666666,17.814652473387603
3,423705,ΔΗΜΟΣ ΚΑΛΑΒΡΥΤΩΝ,11045,3619,3041,999,502,1540,578,7426,32.851035843472545,16.50772772114436,50.6412364353831,15.971262779773419
3,423801,ΔΗΜΟΣ ΙΕΡΑΣ ΠΟΛΗΣ ΜΕΣΟΛΟΓΓΙΟΥ,34416,12492,9948,3070,1397,5481,2544,21924,30.860474467229594,14.043023723361479,55.09650180940893,20.36503362151777
3,423802,ΔΗΜΟΣ ΑΚΤΙΟΥ - ΒΟΝΙΤΣΑΣ,17370,6032,4905,2038,820,2047,1127,11338,41.54943934760448,16.717635066258918,41.732925586136595,18.68368700265252
3,423803,ΔΗΜΟΣ ΑΓΡΙΝΙΟΥ,94181,35539,27172,4793,4327,18052,8367,58642,17.639481819520093,15.924481083468276,66.43603709701163,23.5431497791159
3,423804,ΔΗΜΟΣ ΑΜΦΙΛΟΧΙΑΣ,17056,5654,4549,1937,659,1953,1105,11402,42.580786986150805,14.486700373708507,42.93251264014069,19.543685886098338
3,423805,ΔΗΜΟΣ ΘΕΡΜΟΥ,8242,2543,2078,594,390,1094,465,5699,28.585178055822908,18.768046198267566,52.64677574590953,18.285489579237122
3,423806,ΔΗΜΟΣ ΝΑΥΠΑΚΤΙΑΣ,27800,9982,7774,965,1610,5199,2208,17818,12.413172112168768,20.71005917159763,66.8767687162336,22.119815668202765
3,423807,ΔΗΜΟΣ ΞΗΡΟΜΕΡΟΥ,11737,4129,3312,1939,288,1085,817,7608,58.54468599033817,8.695652173913043,32.759661835748794,19.78687333494793
3,423901,ΔΗΜΟΣ ΠΥΡΓΟΥ,47995,18469,14652,2699,2177,9776,3817,29526,18.42069342069342,14.858039858039858,66.72126672126672,20.66706372840977
3,423902,ΔΗΜΟΣ ΗΛΙΔΑΣ,32219,12889,10136,2788,1843,5505,2753,19330,27.505919494869772,18.18271507498027,54.31136543014996,21.359298626735978
3,423903,ΔΗΜΟΣ ΑΝΔΡΑΒΙΔΑΣ - ΚΥΛΛΗΝΗΣ,21581,9261,7894,3590,884,3420,1367,12320,45.477577907271346,11.198378515328097,43.32404357740056,14.760824964906597
3,423904,ΔΗΜΟΣ ΑΝΔΡΙΤΣΑΙΝΑΣ - ΚΡΕΣΤΕΝΩΝ,14109,4949,3769,1632,542,1595,1180,9160,43.30061024144335,14.380472273812682,42.31891748474396,23.84320064659527
3,423905,ΔΗΜΟΣ ΑΡΧΑΙΑΣ ΟΛΥΜΠΙΑΣ,13409,4555,3714,1214,468,2032,841,8854,32.687129779213784,12.60096930533118,54.71190091545503,18.463227222832053
3,423906,ΔΗΜΟΣ ΖΑΧΑΡΩΣ,8953,3152,2580,963,369,1248,572,5801,37.325581395348834,14.30232558139535,48.372093023255815,18.14720812182741
3,423907,ΔΗΜΟΣ ΠΗΝΕΙΟΥ,21034,8599,6826,2973,980,2873,1773,12435,43.55405801347788,14.356870788162906,42.089071198359214,20.6186765903012
3,434001,ΔΗΜΟΣ ΤΡΙΠΟΛΗΣ,47254,19837,17068,2299,3398,11371,2769,27417,13.469650808530584,19.908600890555427,66.62174830091399,13.958763925996875
3,434002,ΔΗΜΟΣ ΒΟΡΕΙΑΣ ΚΥΝΟΥΡΙΑΣ,10341,3895,3214,815,624,1775,681,6446,25.35780958307405,19.4150591163659,55.22713130056005,17.48395378690629
3,434003,ΔΗΜΟΣ ΓΟΡΤΥΝΙΑΣ,10109,2677,2172,675,468,1029,505,7432,31.07734806629834,21.54696132596685,47.3756906077348,18.86440044826298
3,434004,ΔΗΜΟΣ ΜΕΓΑΛΟΠΟΛΗΣ,10687,3735,3097,254,1338,1505,638,6952,8.201485308362932,43.20309977397481,48.595414917662254,17.081659973226238
3,434005,ΔΗΜΟΣ ΝΟΤΙΑΣ ΚΥΝΟΥΡΙΑΣ,8294,3184,2685,1027,427,1231,499,5110,38.24953445065177,15.90316573556797,45.84729981378026,15.672110552763819
3,434101,ΔΗΜΟΣ ΝΑΥΠΛΙΕΩΝ,33356,14327,12045,2283,1663,8099,2282,19029,18.953922789539227,13.806558738065588,67.23951847239519,15.92796817198297
3,434102,ΔΗΜΟΣ ΑΡΓΟΥΣ - ΜΥΚΗΝΩΝ,42022,17605,14605,3917,2503,8185,3000,24417,26.819582334816843,17.137966449845944,56.042451215337216,17.040613462084636
3,434103,ΔΗΜΟΣ ΕΠΙΔΑΥΡΟΥ,8115,3108,2713,1110,415,1188,395,5007,40.91411721341688,15.296719498709916,43.7891632878732,12.709137709137709
3,434104,ΔΗΜΟΣ ΕΡΜΙΟΝΙΔΑΣ,13551,5676,4802,913,1203,2686,874,7875,19.012911286963764,25.052061640982924,55.93502707205331,15.398167723749118
3,434201,ΔΗΜΟΣ ΚΟΡΙΝΘΙΩΝ,58192,24427,19965,2567,4436,12962,4462,33765,12.857500626095668,22.218883045329328,64.92361632857501,18.266672125107462
3,434202,ΔΗΜΟΣ ΒΕΛΟΥ - ΒΟΧΑΣ,19027,8016,6672,2007,1109,3556,1344,11011,30.08093525179856,16.621702637889687,53.29736211031175,16.766467065868262
3,434203,ΔΗΜΟΣ ΛΟΥΤΡΑΚΙΟΥ - ΑΓΙΩΝ ΘΕΟΔΩΡΩΝ,21221,8450,6751,297,1505,4949,1699,12771,4.3993482447044885,22.29299363057325,73.30765812472227,20.106508875739646
3,434204,ΔΗΜΟΣ ΝΕΜΕΑΣ,6483,2592,2280,1112,258,910,312,3891,48.771929824561404,11.31578947368421,39.91228070175438,12.037037037037036
3,434205,ΔΗΜΟΣ ΞΥΛΟΚΑΣΤΡΟΥ - ΕΥΡΩΣΤΙΝΗΣ,17365,6776,5718,1813,811,3094,1058,10589,31.706890521161245,14.183280867436167,54.10982861140259,15.613931523022432
3,434206,ΔΗΜΟΣ ΣΙΚΥΩΝΙΩΝ,22794,9611,8068,2724,1276,4068,1543,13183,33.76301437778879,15.815567674764502,50.421417947446706,16.05452086151285
3,434301,ΔΗΜΟΣ ΣΠΑΡΤΗΣ,35259,13900,11879,2865,1777,7237,2021,21359,24.118191766983752,14.959171647445071,60.922636585571176,14.53956834532374
3,434302,ΔΗΜΟΣ ΑΝΑΤΟΛΙΚΗΣ ΜΑΝΗΣ,13005,4821,4073,1349,564,2160,748,8184,33.12054996317211,13.847287012030444,53.03216302479745,15.515453225471894
3,434303,ΔΗΜΟΣ ΕΛΑΦΟΝΗΣΟΥ,1041,433,366,84,42,240,67,608,22.950819672131146,11.475409836065573,65.57377049180327,15.473441108545035
3,434304,ΔΗΜΟΣ ΕΥΡΩΤΑ,17891,7998,7192,4494,607,2091,806,9893,62.4860956618465,8.439933259176863,29.07397107897664,10.077519379844961
3,434305,ΔΗΜΟΣ ΜΟΝΕΜΒΑΣΙΑΣ,21942,8571,7504,3298,961,3245,1067,13371,43.949893390191896,12.806503198294243,43.24360341151386,12.44895578112239
3,434401,ΔΗΜΟΣ ΚΑΛΑΜΑΤΑΣ,69849,29749,23967,1746,4280,17941,5782,40100,7.285016898235074,17.857887929236032,74.8570951725289,19.435947426804262
3,434402,ΔΗΜΟΣ ΔΥΤΙΚΗΣ ΜΑΝΗΣ,6945,2439,2160,742,371,1047,279,4506,34.351851851851855,17.175925925925927,48.47222222222222,11.439114391143912
3,434403,ΔΗΜΟΣ ΜΕΣΣΗΝΗΣ,23482,8397,7050,2762,932,3356,1347,15085,39.177304964539005,13.21985815602837,47.60283687943262,16.041443372633083
3,434404,ΔΗΜΟΣ ΟΙΧΑΛΙΑΣ,11228,3632,2996,991,524,1481,636,7596,33.07743658210948,17.489986648865152,49.43257676902537,17.51101321585903
3,434405,ΔΗΜΟΣ ΠΥΛΟΥ - ΝΕΣΤΟΡΟΣ,21077,7925,6981,3140,925,2916,944,13152,44.97922933677123,13.250250680418278,41.770519982810484,11.911671924290221
3,434406,ΔΗΜΟΣ ΤΡΙΦΥΛΙΑΣ,27373,12205,10738,5155,1323,4260,1467,15168,48.00707766809462,12.320730117340286,39.672192214565094,12.019664072101598
3,514501,ΔΗΜΟΣ ΑΘΗΝΑΙΩΝ,664046,327389,260658,1273,42683,216702,66731,336657,0.48837940903405996,16.375096870228422,83.13652372073751,20.38278622678221
3,514502,ΔΗΜΟΣ ΒΥΡΩΝΟΣ,61308,28423,23679,81,3474,20124,4744,32885,0.34207525655644244,14.671227670087418,84.98669707335614,16.69070822925096
3,514503,ΔΗΜΟΣ ΓΑΛΑΤΣΙΟΥ,59345,28276,23395,115,3762,19518,4881,31069,0.4915580252190639,16.08035905107929,83.42808292370165,17.261988965907484
3,514504,ΔΗΜΟΣ ΔΑΦΝΗΣ - ΥΜΗΤΤΟΥ,33628,15877,13017,42,2067,10908,2860,17751,0.3226549896289468,15.87923484673888,83.79811016363217,18.013478616867168
3,514505,ΔΗΜΟΣ ΖΩΓΡΑΦΟΥ,71026,31956,26546,93,3173,23280,5410,39070,0.35033526708355306,11.952836585549612,87.69682814736683,16.929528101139066
3,514506,ΔΗΜΟΣ ΗΛΙΟΥΠΟΛΕΩΣ,78153,36410,30527,124,4519,25884,5883,41743,0.4061977921184525,14.803288891800701,84.79051331608085,16.157648997528153
3,514507,ΔΗΜΟΣ ΚΑΙΣΑΡΙΑΝΗΣ,26458,12431,10287,25,1378,8884,2144,14027,0.2430251774083795,13.39554777874988,86.36142704384174,17.247204569222106
3,514508,ΔΗΜΟΣ ΦΙΛΑΔΕΛΦΕΙΑΣ - ΧΑΛΚΗΔΟΝΟΣ,35556,16855,13716,75,2524,11117,3139,18701,0.5468066491688539,18.401866433362496,81.05132691746864,18.623553841590034
3,514601,ΔΗΜΟΣ ΑΜΑΡΟΥΣΙΟΥ,72333,34143,29960,139,3794,26027,4183,38190,0.46395193591455275,12.663551401869158,86.87249666221629,12.251413174003456
3,514602,ΔΗΜΟΣ ΑΓΙΑΣ ΠΑΡΑΣΚΕΥΗΣ,59704,28166,24581,76,2798,21707,3585,31538,0.3091818884504292,11.382775314267118,88.30804279728245,12.728111907974153
3,514603,ΔΗΜΟΣ ΒΡΙΛΗΣΣΙΩΝ,30741,14376,12861,60,1586,11215,1515,16365,0.4665267086540704,12.331855998755929,87.20161729259,10.53839732888147
3,514604,ΔΗΜΟΣ ΗΡΑΚΛΕΙΟΥ,49642,23824,20251,87,3335,16829,3573,25818,0.42960841439928893,16.468322551972744,83.10206903362797,14.997481531229013
3,514605,ΔΗΜΟΣ ΚΗΦΙΣΙΑΣ,71259,32282,28790,217,4011,24562,3492,38977,0.7537339353942341,13.93192080583536,85.3143452587704,10.817173657146398
3,514606,ΔΗΜΟΣ ΛΥΚΟΒΡΥΣΗΣ - ΠΕΥΚΗΣ,31153,14651,12663,76,1996,10591,1988,16502,0.6001737345020927,15.76245755350233,83.63736871199558,13.569039655996178
3,514607,ΔΗΜΟΣ ΜΕΤΑΜΟΡΦΩΣΕΩΣ,29891,14585,12170,81,2528,9561,2415,15306,0.6655710764174199,20.772391125718983,78.5620377978636,16.55810764484059
3,514608,ΔΗΜΟΣ ΝΕΑΣ ΙΩΝΙΑΣ,67134,32465,26325,127,4685,21513,6140,34669,0.48243114909781576,17.796771130104464,81.72079772079772,18.912675188664714
3,514609,ΔΗΜΟΣ ΠΑΠΑΓΟΥ - ΧΟΛΑΡΓΟΥ,44539,19773,17492,54,1778,15660,2281,24766,0.30871255431054195,10.164646695632289,89.52664075005717,11.535932837707985
3,514610,ΔΗΜΟΣ ΠΕΝΤΕΛΗΣ,34934,16470,14447,67,1891,12489,2023,18464,0.4637641032740361,13.089222675988095,86.44701322073787,12.282938676381299
3,514611,ΔΗΜΟΣ ΦΙΛΟΘΕΗΣ - ΨΥΧΙΚΟΥ,26968,12357,11267,45,1087,10135,1090,14611,0.39939646756013136,9.647643560841395,89.95295997159847,8.820911224407219
3,514612,ΔΗΜΟΣ ΧΑΛΑΝΔΡΙΟΥ,74192,34846,30329,131,3539,26659,4517,39346,0.43192983613043623,11.66869992416499,87.89937023970457,12.962750387418929
3,514701,ΔΗΜΟΣ ΠΕΡΙΣΤΕΡΙΟΥ,139981,65847,52316,257,10581,41478,13531,74134,0.4912455080663659,20.22517012003976,79.28358437189388,20.54915182164715
3,514702,ΔΗΜΟΣ ΑΓΙΑΣ ΒΑΡΒΑΡΑΣ,26550,11277,8503,35,1620,6848,2774,15273,0.4116194284370222,19.05209925908503,80.53628131247795,24.598740799858117
3,514703,ΔΗΜΟΣ ΑΓΙΩΝ ΑΝΑΡΓΥΡΩΝ - ΚΑΜΑΤΕΡΟΥ,62529,29390,23870,116,5186,18568,5520,33139,0.48596564725596986,21.726015919564308,77.78801843317973,18.781898604967676
3,514704,ΔΗΜΟΣ ΑΙΓΑΛΕΩ,69946,31877,24825,157,4749,19919,7052,38069,0.6324269889224572,19.129909365558913,80.23766364551864,22.122533488094863
3,514705,ΔΗΜΟΣ ΙΛΙΟΥ,84793,39469,31711,155,6673,24883,7758,45324,0.48878937907981457,21.043171139352275,78.46803948156791,19.655932503990474
3,514706,ΔΗΜΟΣ ΠΕΤΡΟΥΠΟΛΕΩΣ,58979,28322,23550,93,4137,19320,4772,30657,0.39490445859872614,17.56687898089172,82.03821656050955,16.849092578207753
3,514707,ΔΗΜΟΣ ΧΑΪΔΑΡΙΟΥ,46897,21218,17722,83,2938,14701,3496,25679,0.46834443065116804,16.5782643042546,82.95339126509424,16.476576491658026
3,514801,ΔΗΜΟΣ ΚΑΛΛΙΘΕΑΣ,100641,46707,37371,168,5665,31538,9336,53934,0.44954643975274944,15.15881298332932,84.39164057691794,19.988438563812704
3,514802,ΔΗΜΟΣ ΑΓΙΟΥ ΔΗΜΗΤΡΙΟΥ,71294,34137,28261,145,5013,23103,5876,37157,0.5130745550405152,17.73822582357312,81.74869962138636,17.212994697835192
3,514803,ΔΗΜΟΣ ΑΛΙΜΟΥ,41720,19262,16653,60,2181,14412,2609,22458,0.36029544226265536,13.096739326247523,86.54296523148982,13.54480323953899
3,514804,ΔΗΜΟΣ ΓΛΥΦΑΔΑΣ,87305,39814,34153,158,4486,29509,5661,47491,0.46262407401985184,13.135010101601615,86.40236582437853,14.21861656703672
3,514805,ΔΗΜΟΣ ΕΛΛΗΝΙΚΟΥ - ΑΡΓΥΡΟΥΠΟΛΗΣ,51356,23539,19979,79,3018,16882,3560,27817,0.3954151859452425,15.105861154211922,84.49872365984284,15.123837036407664
3,514806,ΔΗΜΟΣ ΜΟΣΧΑΤΟΥ - ΤΑΥΡΟΥ,40413,19394,15579,78,2761,12740,3815,21019,0.5006739842095128,17.72257526157006,81.77675075422043,19.671032278024132
3,514807,ΔΗΜΟΣ ΝΕΑΣ ΣΜΥΡΝΗΣ,73076,34518,29303,79,3394,25830,5215,38558,0.269596969593557,11.58243183291813,88.14797119748832,15.108059563126485
3,514808,ΔΗΜΟΣ ΠΑΛΑΙΟΥ ΦΑΛΗΡΟΥ,64021,28882,24496,117,3061,21318,4386,35139,0.4776290006531679,12.495917700849118,87.02645329849771,15.185928952288622
3,514901,ΔΗΜΟΣ ΑΧΑΡΝΩΝ,106943,49730,38480,534,9606,28340,11250,57213,1.3877338877338878,24.963617463617464,73.64864864864865,22.62215966217575
3,514902,ΔΗΜΟΣ ΒΑΡΗΣ - ΒΟΥΛΑΣ - ΒΟΥΛΙΑΓΜΕΝΗΣ,48399,21152,18568,159,2286,16123,2584,27247,0.8563119345109866,12.311503662214562,86.83218440327445,12.216338880484114
3,514903,ΔΗΜΟΣ ΔΙΟΝΥΣΟΥ,40193,18598,16530,127,2884,13519,2068,21595,0.7683000604960678,17.447065940713852,81.78463399879008,11.119475212388428
3,514904,ΔΗΜΟΣ ΚΡΩΠΙΑΣ,30307,13723,11225,447,2911,7867,2498,16584,3.9821826280623607,25.933184855233854,70.08463251670379,18.203016833053997
3,514905,ΔΗΜΟΣ ΛΑΥΡΕΩΤΙΚΗΣ,25102,10192,7747,229,1918,5600,2445,14910,2.9559829611462503,24.757970827417065,72.28604621143668,23.989403453689167
3,514906,ΔΗΜΟΣ ΜΑΡΑΘΩΝΟΣ,33423,16538,13953,3864,2154,7935,2585,16885,27.692969253923888,15.437540313910986,56.86949043216512,15.630668762849195
3,514907,ΔΗΜΟΣ ΜΑΡΚΟΠΟΥΛΟΥ ΜΕΣΟΓΑΙΑΣ,20040,8674,7354,250,1484,5620,1320,11366,3.399510470492249,20.17949415284199,76.42099537666576,15.217892552455615
3,514908,ΔΗΜΟΣ ΠΑΙΑΝΙΑΣ,26668,12657,10768,297,2149,8322,1889,14011,2.7581723625557206,19.957280832095098,77.28454680534918,14.92454768112507
3,514909,ΔΗΜΟΣ ΠΑΛΛΗΝΗΣ,54415,27154,23569,131,3943,19495,3585,27261,0.5558148415291272,16.729602443888158,82.71458271458272,13.20247477351403
3,514910,ΔΗΜΟΣ ΡΑΦΗΝΑΣ - ΠΙΚΕΡΜΙΟΥ,20266,9128,7920,93,1286,6541,1208,11138,1.1742424242424243,16.237373737373737,82.58838383838383,13.234005258545135
3,514911,ΔΗΜΟΣ ΣΑΡΩΝΙΚΟΥ,29002,12078,9980,294,1874,7812,2098,16924,2.9458917835671343,18.77755511022044,78.27655310621242,17.370425567146878
3,514912,ΔΗΜΟΣ ΣΠΑΤΩΝ - ΑΡΤΕΜΙΔΟΣ,33821,14442,11763,299,2429,9035,2679,19379,2.541868570942787,20.649494176655615,76.8086372524016,18.55006231823847
3,514913,ΔΗΜΟΣ ΩΡΩΠΟΥ,33769,12343,10260,828,2531,6901,2083,21426,8.070175438596491,24.66861598440546,67.26120857699804,16.87596208377218
3,515001,ΔΗΜΟΣ ΕΛΕΥΣΙΝΑΣ,29902,13701,11064,126,3361,7577,2637,16201,1.13882863340564,30.377801879971077,68.48336948662329,19.24677030873659
3,515002,ΔΗΜΟΣ ΑΣΠΡΟΠΥΡΓΟΥ,30251,13187,9341,341,3248,5752,3846,17064,3.6505727438175786,34.7714377475645,61.57798950861792,29.165086827936605
3,515003,ΔΗΜΟΣ ΜΑΝΔΡΑΣ - ΕΙΔΥΛΛΙΑΣ,17885,7369,5995,320,1785,3890,1374,10516,5.337781484570475,29.774812343619683,64.88740617180984,18.645677839598317
3,515004,ΔΗΜΟΣ ΜΕΓΑΡΕΩΝ,36924,15059,11694,1621,2920,7153,3365,21865,13.861809474944415,24.970070121429792,61.16812040362579,22.345441264360183
3,515005,ΔΗΜΟΣ ΦΥΛΗΣ,45965,20353,15421,137,3649,11635,4932,25612,0.8883989365151417,23.66253809739965,75.44906296608521,24.23229990664767
3,515101,ΔΗΜΟΣ ΠΕΙΡΑΙΩΣ,163688,73551,59122,297,9215,49610,14429,90137,0.5023510706674335,15.586414532661276,83.91123439667129,19.61768024907887
3,515102,ΔΗΜΟΣ ΚΕΡΑΤΣΙΝΙΟΥ - ΔΡΑΠΕΤΣΩΝΑΣ,91045,39990,31842,175,5929,25738,8148,51055,0.5495885936813014,18.620061553922493,80.83034985239621,20.37509377344336
3,515103,ΔΗΜΟΣ ΚΟΡΥΔΑΛΛΟΥ,63445,26838,21351,86,3881,17384,5487,36607,0.4027914383401246,18.177134560442134,81.42007400121774,20.444891571652136
3,515104,ΔΗΜΟΣ ΝΙΚΑΙΑΣ - ΑΓΙΟΥ ΙΩΑΝΝΗ ΡΕΝΤΗ,105430,47393,37009,223,7546,29240,10384,58037,0.6025561349941906,20.38963495365992,79.00780891134589,21.910408710147067
3,515105,ΔΗΜΟΣ ΠΕΡΑΜΑΤΟΣ,25389,11258,8345,53,1697,6595,2913,14131,0.6351108448172559,20.335530257639306,79.02935889754345,25.874933380707052
3,515201,ΔΗΜΟΣ ΣΑΛΑΜΙΝΟΣ,39283,13546,10374,256,1795,8323,3172,25737,2.4677077308656257,17.302872566030462,80.22941970310391,23.41650671785029
3,515202,ΔΗΜΟΣ ΥΔΡΑΣ,1966,801,646,30,90,526,155,1165,4.643962848297214,13.93188854489164,81.42414860681114,19.350811485642947
3,515203,ΔΗΜΟΣ ΑΓΚΙΣΤΡΙΟΥ,1142,425,363,10,70,283,62,717,2.7548209366391183,19.28374655647383,77.96143250688705,14.588235294117647
3,515204,ΔΗΜΟΣ ΑΙΓΙΝΑΣ,13056,5061,3963,246,786,2931,1098,7995,6.207418622255867,19.833459500378503,73.95912187736563,21.69531713100178
3,515205,ΔΗΜΟΣ ΚΥΘΗΡΩΝ,4041,1616,1448,211,329,908,168,2425,14.57182320441989,22.72099447513812,62.70718232044199,10.396039603960396
3,515206,ΔΗΜΟΣ ΠΟΡΟΥ,3993,1366,1163,108,115,940,203,2627,9.286328460877042,9.888220120378332,80.82545141874462,14.86090775988287
3,515207,ΔΗΜΟΣ ΣΠΕΤΣΩΝ,4027,1651,1347,57,292,998,304,2376,4.23162583518931,21.677802524127692,74.090571640683,18.413082980012113
3,515208,ΔΗΜΟΣ ΤΡΟΙΖΗΝΙΑΣ,7143,2780,2345,911,327,1107,435,4363,38.84861407249467,13.94456289978678,47.20682302771855,15.647482014388489
3,615301,ΔΗΜΟΣ ΛΕΣΒΟΥ,86436,32722,27909,4847,3916,19146,4813,53714,17.367157547744455,14.031316062918771,68.60152638933677,14.708758633335371
3,615401,ΔΗΜΟΣ ΙΚΑΡΙΑΣ,8423,3276,2736,673,504,1559,540,5147,24.59795321637427,18.42105263157895,56.98099415204678,16.483516483516482
3,615402,ΔΗΜΟΣ ΦΟΥΡΝΩΝ ΚΟΡΣΕΩΝ,1459,428,332,30,49,253,96,1031,9.036144578313253,14.759036144578314,76.20481927710843,22.429906542056074
3,615501,ΔΗΜΟΣ ΛΗΜΝΟΥ,16992,6756,5915,781,866,4268,841,10236,13.203719357565511,14.640743871513102,72.15553677092139,12.448194197750148
3,615502,ΔΗΜΟΣ ΑΓΙΟΥ ΕΥΣΤΡΑΤΙΟΥ,270,87,79,26,13,40,8,183,32.91139240506329,16.455696202531644,50.63291139240506,9.195402298850574
3,615601,ΔΗΜΟΣ ΣΑΜΟΥ,32977,13213,11435,1215,1503,8717,1778,19764,10.625273283777876,13.143856580673372,76.23087013554876,13.456444410807539
3,615701,ΔΗΜΟΣ ΧΙΟΥ,51390,19744,17154,1386,2758,13010,2590,31646,8.0797481636936,16.077882709572112,75.84236912673428,13.117909238249595
3,615702,ΔΗΜΟΣ ΟΙΝΟΥΣΣΩΝ,826,243,219,26,38,155,24,583,11.872146118721462,17.35159817351598,70.77625570776256,9.876543209876543
3,615703,ΔΗΜΟΣ ΨΑΡΩΝ,458,159,130,16,13,101,29,299,12.307692307692308,10.0,77.6923076923077,18.238993710691823
3,625801,ΔΗΜΟΣ ΣΥΡΟΥ - ΕΡΜΟΥΠΟΛΗΣ,21507,9034,7525,218,1538,5769,1509,12473,2.8970099667774085,20.438538205980066,76.66445182724253,16.703564312596857
3,625901,ΔΗΜΟΣ ΑΝΔΡΟΥ,9221,3554,3093,479,831,1783,461,5667,15.486582605884255,26.867119301648884,57.646298092466864,12.97129994372538
3,626001,ΔΗΜΟΣ ΘΗΡΑΣ,15550,7667,6687,236,1121,5330,980,7883,3.529235830716315,16.7638701959025,79.70689397338118,12.782052954219381
3,626002,ΔΗΜΟΣ ΑΝΑΦΗΣ,271,111,99,28,16,55,12,160,28.282828282828284,16.161616161616163,55.55555555555556,10.81081081081081
3,626003,ΔΗΜΟΣ ΙΗΤΩΝ,2024,986,880,73,187,620,106,1038,8.295454545454545,21.25,70.45454545454545,10.75050709939148
3,626004,ΔΗΜΟΣ ΣΙΚΙΝΟΥ,273,101,86,15,18,53,15,172,17.441860465116278,20.930232558139537,61.627906976744185,14.851485148514852
3,626005,ΔΗΜΟΣ ΦΟΛΕΓΑΝΔΡΟΥ,765,346,314,35,74,205,32,419,11.146496815286625,23.56687898089172,65.28662420382166,9.248554913294798
3,626101,ΔΗΜΟΣ ΚΑΛΥΜΝΙΩΝ,16179,5881,4754,499,942,3313,1127,10298,10.49642406394615,19.814892721918383,69.68868321413547,19.16340758374426
3,626102,ΔΗΜΟΣ ΑΓΑΘΟΝΗΣΙΟΥ,185,87,75,24,8,43,12,98,32.0,10.666666666666666,57.333333333333336,13.793103448275861
3,626103,ΔΗΜΟΣ ΑΣΤΥΠΑΛΑΙΑΣ,1334,516,438,62,120,256,78,818,14.155251141552512,27.397260273972602,58.44748858447488,15.116279069767442
3,626104,ΔΗΜΟΣ ΛΕΙΨΩΝ,790,321,285,37,57,191,36,469,12.982456140350877,20.0,67.01754385964912,11.214953271028037
3,626105,ΔΗΜΟΣ ΛΕΡΟΥ,7917,3113,2632,169,385,2078,481,4804,6.420972644376899,14.627659574468085,78.95136778115501,15.451333119177642
3,626106,ΔΗΜΟΣ ΠΑΤΜΟΥ,3047,1337,1200,70,266,864,137,1710,5.833333333333333,22.166666666666668,72.0,10.24682124158564
3,626201,ΔΗΜΟΣ ΚΑΡΠΑΘΟΥ,6226,2744,2305,177,398,1730,439,3482,7.678958785249458,17.266811279826463,75.05422993492408,15.998542274052479
3,626202,ΔΗΜΟΣ ΚΑΣΟΥ,1084,334,267,41,55,171,67,750,15.355805243445692,20.59925093632959,64.04494382022472,20.059880239520957
3,626301,ΔΗΜΟΣ ΚΕΑΣ,2455,988,896,143,272,481,92,1467,15.959821428571429,30.357142857142858,53.683035714285715,9.31174089068826
3,626302,ΔΗΜΟΣ ΚΥΘΝΟΥ,1456,599,551,131,144,276,48,857,23.77495462794918,26.134301270417424,50.09074410163339,8.013355592654424
3,626401,ΔΗΜΟΣ ΚΩ,33388,17291,15357,423,1556,13378,1934,16097,2.754444227388162,10.132187276160709,87.11336849645113,11.18500954253658
3,626402,ΔΗΜΟΣ ΝΙΣΥΡΟΥ,1008,441,327,23,77,227,114,567,7.033639143730887,23.547400611620795,69.41896024464832,25.85034013605442
3,626501,ΔΗΜΟΣ ΜΗΛΟΥ,4977,1965,1791,66,533,1192,174,3012,3.6850921273031827,29.759910664433278,66.55499720826354,8.854961832061068
3,626502,ΔΗΜΟΣ ΚΙΜΩΛΟΥ,910,219,199,21,71,107,20,691,10.552763819095478,35.678391959798994,53.768844221105525,9.132420091324201
3,626503,ΔΗΜΟΣ ΣΕΡΙΦΟΥ,1420,543,484,43,144,297,59,877,8.884297520661157,29.75206611570248,61.36363636363637,10.865561694290976
3,626504,ΔΗΜΟΣ ΣΙΦΝΟΥ,2625,982,902,74,254,574,80,1643,8.203991130820398,28.159645232815965,63.63636363636363,8.146639511201629
3,626601,ΔΗΜΟΣ ΜΥΚΟΝΟΥ,10134,5555,4943,135,1006,3802,612,4579,2.731134938296581,20.35201294760267,76.91685211410075,11.017101710171017
3,626701,ΔΗΜΟΣ ΑΜΟΡΓΟΥ,1973,825,737,120,157,460,88,1148,16.28222523744912,21.30257801899593,62.41519674355495,10.666666666666666
3,626702,ΔΗΜΟΣ ΝΑΞΟΥ ΚΑΙ ΜΙΚΡΩΝ ΚΥΚΛΑΔΩΝ,18904,7789,6571,899,1420,4252,1218,11115,13.681327043068027,21.610105006848272,64.7085679500837,15.637437411734497
3,626801,ΔΗΜΟΣ ΠΑΡΟΥ,13715,6081,5375,337,1375,3663,706,7634,6.269767441860465,25.58139534883721,68.14883720930233,11.609932576878803
3,626802,ΔΗΜΟΣ ΑΝΤΙΠΑΡΟΥ,1211,456,396,46,81,269,60,755,11.616161616161616,20.454545454545453,67.92929292929293,13.157894736842104
3,626901,ΔΗΜΟΣ ΡΟΔΟΥ,115490,54663,47009,1301,6343,39365,7654,60827,2.7675551490140187,13.493160884086025,83.73928396689996,14.00215868137497
3,626902,ΔΗΜΟΣ ΜΕΓΙΣΤΗΣ,492,213,199,14,49,136,14,279,7.035175879396985,24.623115577889447,68.34170854271356,6.572769953051643
3,626903,ΔΗΜΟΣ ΣΥΜΗΣ,2590,1073,941,44,189,708,132,1517,4.675876726886291,20.08501594048884,75.23910733262487,12.301957129543336
3,626904,ΔΗΜΟΣ ΤΗΛΟΥ,780,303,277,26,46,205,26,477,9.386281588447654,16.60649819494585,74.0072202166065,8.58085808580858
3,626905,ΔΗΜΟΣ ΧΑΛΚΗΣ,478,234,191,11,38,142,43,244,5.7591623036649215,19.895287958115183,74.3455497382199,18.376068376068375
3,627001,ΔΗΜΟΣ ΤΗΝΟΥ,8636,3664,3164,225,829,2110,500,4972,7.111251580278129,26.20101137800253,66.68773704171934,13.646288209606986
3,717101,ΔΗΜΟΣ ΗΡΑΚΛΕΙΟΥ,173993,79369,64269,2706,10136,51427,15100,94624,4.210428044624936,15.771211626133907,80.01836032924116,19.025060162027994
3,717102,ΔΗΜΟΣ ΑΡΧΑΝΩΝ - ΑΣΤΕΡΟΥΣΙΩΝ,16692,6247,5361,1891,769,2701,886,10445,35.27326991232979,14.344338742771871,50.38239134489834,14.182807747718906
3,717103,ΔΗΜΟΣ ΒΙΑΝΝΟΥ,5563,1993,1782,1007,132,643,211,3570,56.509539842873174,7.407407407407407,36.083052749719414,10.58705469141997
3,717104,ΔΗΜΟΣ ΓΟΡΤΥΝΑΣ,15632,5321,4456,2183,600,1673,865,10311,48.99012567324955,13.464991023339318,37.54488330341113,16.25634279270814
3,717105,ΔΗΜΟΣ ΜΑΛΕΒΙΖΙΟΥ,24864,11548,9439,956,1649,6834,2109,13316,10.12819154571459,17.47007098209556,72.40173747218985,18.262902667128508
3,717106,ΔΗΜΟΣ ΜΙΝΩΑ ΠΕΔΙΑΔΑΣ,17563,6422,5124,1579,836,2709,1298,11141,30.815768930523028,16.315378610460577,52.868852459016395,20.211772033634382
3,717107,ΔΗΜΟΣ ΦΑΙΣΤΟΥ,24466,10296,8885,3722,1188,3975,1411,14170,41.89082723691615,13.37084974676421,44.73832301631964,13.704351204351203
3,717108,ΔΗΜΟΣ ΧΕΡΣΟΝΗΣΟΥ,26717,12470,10311,616,1332,8363,2159,14247,5.974202308214529,12.91824265347687,81.1075550383086,17.31355252606255
3,717201,ΔΗΜΟΣ ΑΓΙΟΥ ΝΙΚΟΛΑΟΥ,27074,12074,10413,541,1376,8496,1661,15000,5.195428790934409,13.214251416498607,81.59031979256699,13.7568328640053
3,717202,ΔΗΜΟΣ ΙΕΡΑΠΕΤΡΑΣ,27602,13030,11444,4731,1092,5621,1586,14572,41.34044040545264,9.542118140510311,49.11744145403705,12.17191097467383
3,717203,ΔΗΜΟΣ ΟΡΟΠΕΔΙΟΥ ΛΑΣΙΘΙΟΥ,2387,808,744,356,62,326,64,1579,47.8494623655914,8.333333333333334,43.81720430107527,7.920792079207921
3,717204,ΔΗΜΟΣ ΣΗΤΕΙΑΣ,18318,7093,5992,1387,825,3780,1101,11225,23.147530040053404,13.768357810413885,63.08411214953271,15.522345974904836
3,717301,ΔΗΜΟΣ ΡΕΘΥΜΝΗΣ,55525,24582,20658,1416,3237,16005,3924,30943,6.854487365669474,15.669474295672378,77.47603833865814,15.962899682694655
3,717302,ΔΗΜΟΣ ΑΓΙΟΥ ΒΑΣΙΛΕΙΟΥ,7427,2782,2477,817,237,1423,305,4645,32.98344771901494,9.568025837706903,57.44852644327816,10.96333572969087
3,717303,ΔΗΜΟΣ ΑΜΑΡΙΟΥ,5915,2089,1787,676,207,904,302,3826,37.82876329043089,11.583659764969223,50.58757694459989,14.456677836285303
3,717304,ΔΗΜΟΣ ΑΝΩΓΕΙΩΝ,2379,895,801,315,87,399,94,1484,39.325842696629216,10.861423220973784,49.81273408239701,10.502793296089385
3,717305,ΔΗΜΟΣ ΜΥΛΟΠΟΤΑΜΟΥ,14363,5293,4776,1915,590,2271,517,9070,40.096314907872696,12.353433835845896,47.550251256281406,9.767617608161723
3,717401,ΔΗΜΟΣ ΧΑΝΙΩΝ,108642,49424,41417,1460,6443,33514,8007,59218,3.5251225342250767,15.556414032885048,80.91846343288988,16.200631272256395
3,717402,ΔΗΜΟΣ ΑΠΟΚΟΡΩΝΟΥ,12807,4692,4006,819,607,2580,686,8115,20.444333499750375,15.152271592611083,64.40339490763854,14.620630861040068
3,717403,ΔΗΜΟΣ ΓΑΥΔΟΥ,152,80,68,20,11,37,12,72,29.41176470588235,16.176470588235293,54.411764705882355,15.0
3,717404,ΔΗΜΟΣ ΚΑΝΤΑΝΟΥ - ΣΕΛΙΝΟΥ,5431,2198,1925,908,165,852,273,3233,47.16883116883117,8.571428571428571,44.25974025974026,12.420382165605096
3,717405,ΔΗΜΟΣ ΚΙΣΣΑΜΟΥ,10790,3950,3417,1217,521,1679,533,6840,35.61603745976002,15.247292947029559,49.13666959321042,13.49367088607595
3,717406,ΔΗΜΟΣ ΠΛΑΤΑΝΙΑ,16874,6504,5532,1659,599,3274,972,10370,29.989154013015185,10.827910339840926,59.18293564714389,14.944649446494465
3,717407,ΔΗΜΟΣ ΣΦΑΚΙΩΝ,1889,713,634,361,39,234,79,1176,56.94006309148265,6.151419558359621,36.90851735015773,11.079943899018232
