"Επίπεδο διοικητικής διαίρεσης";"Γεωγραφικός κωδικός";"Περιγραφή";"Σύνολο";"Σύνολο οικονομικών ενεργών";"Σύνολο απασχολούμενων";"Πρωτογενής Τομέας";"Δευτερογενής Τομέας";"Τριτογενής Τομέας";"Ανεργοι";"Οικονομικά μη ενεργοί"
0;0;"ΣΥΝΟΛΟ ΧΩΡΑΣ";10816286;4586636;3727633;372209;654377;2701047;859003;6229650
1;11;"ΠΕΡΙΦΕΡΕΙΑ ΑΝΑΤΟΛΙΚΗΣ ΜΑΚΕΔΟΝΙΑΣ ΚΑΙ ΘΡΑΚΗΣ";608182;234579;187306;38787;30892;117627;47273;373603
1;12;"ΠΕΡΙΦΕΡΕΙΑ ΚΕΝΤΡΙΚΗΣ ΜΑΚΕΔΟΝΙΑΣ";1882108;771613;603133;69563;112559;421011;168480;1110495
1;21;"ΠΕΡΙΦΕΡΕΙΑ ΔΥΤΙΚΗΣ ΜΑΚΕΔΟΝΙΑΣ";283689;108094;83530;11792;21697;50041;24564;175595
1;22;"ΠΕΡΙΦΕΡΕΙΑ ΗΠΕΙΡΟΥ";336856;129712;106053;16002;18861;71190;23659;207144
1;31;"ΠΕΡΙΦΕΡΕΙΑ ΘΕΣΣΑΛΙΑΣ";732762;283427;230405;41954;40351;148100;53022;449335
1;32;"ΠΕΡΙΦΕΡΕΙΑ ΣΤΕΡΕΑΣ ΕΛΛΑΔΑΣ";547390;217278;175972;30495;42463;103014;41306;330112
1;41;"ΠΕΡΙΦΕΡΕΙΑ ΙΟΝΙΩΝ ΝΗΣΩΝ";207855;88693;73350;6898;10574;55878;15343;119162
1;42;"ΠΕΡΙΦΕΡΕΙΑ ΔΥΤΙΚΗΣ ΕΛΛΑΔΑΣ";679796;261175;206343;40248;33679;132416;54832;418621
1;43;"ΠΕΡΙΦΕΡΕΙΑ ΠΕΛΟΠΟΝΝΗΣΟΥ";577903;233986;196761;50439;33740;112582;37225;343917
1;51;"ΠΕΡΙΦΕΡΕΙΑ ΑΤΤΙΚΗΣ";3828434;1771562;1452203;17528;246561;1188114;319359;2056872
1;61;"ΠΕΡΙΦΕΡΕΙΑ ΒΟΡΕΙΟΥ ΑΙΓΑΙΟΥ";199231;76628;65909;9000;9660;47249;10719;122603
1;62;"ΠΕΡΙΦΕΡΕΙΑ ΝΟΤΙΟΥ ΑΙΓΑΙΟΥ";309015;140016;120950;6245;20600;94105;19066;168999
1;71;"ΠΕΡΙΦΕΡΕΙΑ ΚΡΗΤΗΣ";623065;269873;225718;33258;32740;159720;44155;353192
2;1101;"ΠΕΡΙΦΕΡΕΙΑΚΗ ΕΝΟΤΗΤΑ ΡΟΔΟΠΗΣ";112039;43013;35798;13180;4890;17728;7215;69026
2;1102;"ΠΕΡΙΦΕΡΕΙΑΚΗ ΕΝΟΤΗΤΑ ΔΡΑΜΑΣ";98287;36720;28020;4558;5471;17991;8700;61567
2;1103;"ΠΕΡΙΦΕΡΕΙΑΚΗ ΕΝΟΤΗΤΑ ΕΒΡΟΥ";147947;57337;48443;8312;5578;34553;8894;90610
2;1104;"ΠΕΡΙΦΕΡΕΙΑΚΗ ΕΝΟΤΗΤΑ ΘΑΣΟΥ";13770;5468;4478;648;854;2976;990;8302
2;1105;"ΠΕΡΙΦΕΡΕΙΑΚΗ ΕΝΟΤΗΤΑ ΚΑΒΑΛΑΣ";124917;48782;38942;6436;7314;25192;9840;76135
2;1106;"ΠΕΡΙΦΕΡΕΙΑΚΗ ΕΝΟΤΗΤΑ ΞΑΝΘΗΣ";111222;43259;31625;5653;6785;19187;11634;67963
2;1207;"ΠΕΡΙΦΕΡΕΙΑΚΗ ΕΝΟΤΗΤΑ ΘΕΣΣΑΛΟΝΙΚΗΣ";1110551;476191;369392;12472;71147;285773;106799;634360
2;1208;"ΠΕΡΙΦΕΡΕΙΑΚΗ ΕΝΟΤΗΤΑ ΗΜΑΘΙΑΣ";140611;55776;43103;10880;7741;24482;12673;84835
2;1209;"ΠΕΡΙΦΕΡΕΙΑΚΗ ΕΝΟΤΗΤΑ ΚΙΛΚΙΣ";80419;29573;22986;4143;5885;12958;6587;50846
2;1210;"ΠΕΡΙΦΕΡΕΙΑΚΗ ΕΝΟΤΗΤΑ ΠΕΛΛΑΣ";139680;54582;43803;14363;7049;22391;10779;85098
2;1211;"ΠΕΡΙΦΕΡΕΙΑΚΗ ΕΝΟΤΗΤΑ ΠΙΕΡΙΑΣ";126698;49451;39424;7842;6582;25000;10027;77247
2;1212;"ΠΕΡΙΦΕΡΕΙΑΚΗ ΕΝΟΤΗΤΑ ΣΕΡΡΩΝ";176430;63057;49976;14151;7239;28586;13081;113373
2;2114;"ΠΕΡΙΦΕΡΕΙΑΚΗ ΕΝΟΤΗΤΑ ΚΟΖΑΝΗΣ";150196;56353;43496;3833;13372;26291;12857;93843
2;2115;"ΠΕΡΙΦΕΡΕΙΑΚΗ ΕΝΟΤΗΤΑ ΓΡΕΒΕΝΩΝ";31757;10835;8673;1892;1432;5349;2162;20922
2;2116;"ΠΕΡΙΦΕΡΕΙΑΚΗ ΕΝΟΤΗΤΑ ΚΑΣΤΟΡΙΑΣ";50322;21266;16007;3027;3444;9536;5259;29056
2;2117;"ΠΕΡΙΦΕΡΕΙΑΚΗ ΕΝΟΤΗΤΑ ΦΛΩΡΙΝΑΣ";51414;19640;15354;3040;3449;8865;4286;31774
2;2218;"ΠΕΡΙΦΕΡΕΙΑΚΗ ΕΝΟΤΗΤΑ ΙΩΑΝΝΙΝΩΝ";167901;66362;54654;5046;10506;39102;11708;101539
2;2219;"ΠΕΡΙΦΕΡΕΙΑΚΗ ΕΝΟΤΗΤΑ ΑΡΤΑΣ";67877;24141;19438;4268;3422;11748;4703;43736
2;2220;"ΠΕΡΙΦΕΡΕΙΑΚΗ ΕΝΟΤΗΤΑ ΘΕΣΠΡΩΤΙΑΣ";43587;17239;13983;2864;2136;8983;3256;26348
2;2221;"ΠΕΡΙΦΕΡΕΙΑΚΗ ΕΝΟΤΗΤΑ ΠΡΕΒΕΖΑΣ";57491;21970;17978;3824;2797;11357;3992;35521
2;3122;"ΠΕΡΙΦΕΡΕΙΑΚΗ ΕΝΟΤΗΤΑ ΛΑΡΙΣΑΣ";284325;112522;92713;17222;15562;59929;19809;171803
2;3123;"ΠΕΡΙΦΕΡΕΙΑΚΗ ΕΝΟΤΗΤΑ ΚΑΡΔΙΤΣΑΣ";113544;41421;33024;9512;4596;18916;8397;72123
2;3124;"ΠΕΡΙΦΕΡΕΙΑΚΗ ΕΝΟΤΗΤΑ ΜΑΓΝΗΣΙΑΣ";190010;74526;60344;7236;12313;40795;14182;115484
2;3125;"ΠΕΡΙΦΕΡΕΙΑΚΗ ΕΝΟΤΗΤΑ ΣΠΟΡΑΔΩΝ";13798;5836;4942;315;890;3737;894;7962
2;3126;"ΠΕΡΙΦΕΡΕΙΑΚΗ ΕΝΟΤΗΤΑ ΤΡΙΚΑΛΩΝ";131085;49122;39382;7669;6990;24723;9740;81963
2;3227;"ΠΕΡΙΦΕΡΕΙΑΚΗ ΕΝΟΤΗΤΑ ΦΘΙΩΤΙΔΑΣ";158231;60535;49322;10389;9318;29615;11213;97696
2;3228;"ΠΕΡΙΦΕΡΕΙΑΚΗ ΕΝΟΤΗΤΑ ΒΟΙΩΤΙΑΣ";117920;51038;42085;8967;11734;21384;8953;66882
2;3229;"ΠΕΡΙΦΕΡΕΙΑΚΗ ΕΝΟΤΗΤΑ ΕΥΒΟΙΑΣ";210815;84791;67990;8373;18227;41390;16801;126024
2;3230;"ΠΕΡΙΦΕΡΕΙΑΚΗ ΕΝΟΤΗΤΑ ΕΥΡΥΤΑΝΙΑΣ";20081;6701;5111;1081;904;3126;1590;13380
2;3231;"ΠΕΡΙΦΕΡΕΙΑΚΗ ΕΝΟΤΗΤΑ ΦΩΚΙΔΑΣ";40343;14213;11464;1685;2280;7499;2749;26130
2;4132;"ΠΕΡΙΦΕΡΕΙΑΚΗ ΕΝΟΤΗΤΑ ΚΕΡΚΥΡΑΣ";104371;44762;36477;2510;4787;29180;8285;59609
2;4133;"ΠΕΡΙΦΕΡΕΙΑΚΗ ΕΝΟΤΗΤΑ ΖΑΚΥΝΘΟΥ";40759;18271;15206;2158;1911;11137;3065;22488
2;4134;"ΠΕΡΙΦΕΡΕΙΑΚΗ ΕΝΟΤΗΤΑ ΙΘΑΚΗΣ";3231;1233;1081;122;234;725;152;1998
2;4135;"ΠΕΡΙΦΕΡΕΙΑΚΗ ΕΝΟΤΗΤΑ ΚΕΦΑΛΛΗΝΙΑΣ";35801;14762;12445;1303;2158;8984;2317;21039
2;4136;"ΠΕΡΙΦΕΡΕΙΑΚΗ ΕΝΟΤΗΤΑ ΛΕΥΚΑΔΑΣ";23693;9665;8141;805;1484;5852;1524;14028
2;4237;"ΠΕΡΙΦΕΡΕΙΑΚΗ ΕΝΟΤΗΤΑ ΑΧΑΪΑΣ";309694;122930;97034;9053;16925;71056;25896;186764
2;4238;"ΠΕΡΙΦΕΡΕΙΑΚΗ ΕΝΟΤΗΤΑ ΑΙΤΩΛΟΑΚΑΡΝΑΝΙΑΣ";210802;76371;59738;15336;9491;34911;16633;134431
2;4239;"ΠΕΡΙΦΕΡΕΙΑΚΗ ΕΝΟΤΗΤΑ ΗΛΕΙΑΣ";159300;61874;49571;15859;7263;26449;12303;97426
2;4340;"ΠΕΡΙΦΕΡΕΙΑΚΗ ΕΝΟΤΗΤΑ ΑΡΚΑΔΙΑΣ";86685;33328;28236;5070;6255;16911;5092;53357
2;4341;"ΠΕΡΙΦΕΡΕΙΑΚΗ ΕΝΟΤΗΤΑ ΑΡΓΟΛΙΔΑΣ";97044;40716;34165;8223;5784;20158;6551;56328
2;4342;"ΠΕΡΙΦΕΡΕΙΑΚΗ ΕΝΟΤΗΤΑ ΚΟΡΙΝΘΙΑΣ";145082;59872;49454;10520;9395;29539;10418;85210
2;4343;"ΠΕΡΙΦΕΡΕΙΑΚΗ ΕΝΟΤΗΤΑ ΛΑΚΩΝΙΑΣ";89138;35723;31014;12090;3951;14973;4709;53415
2;4344;"ΠΕΡΙΦΕΡΕΙΑΚΗ ΕΝΟΤΗΤΑ ΜΕΣΣΗΝΙΑΣ";159954;64347;53892;14536;8355;31001;10455;95607
2;5145;"ΠΕΡΙΦΕΡΕΙΑΚΗ ΕΝΟΤΗΤΑ ΚΕΝΤΡΙΚΟΥ ΤΟΜΕΑ ΑΘΗΝΩΝ";1029520;497617;401825;1828;63580;336417;95792;531903
2;5146;"ΠΕΡΙΦΕΡΕΙΑΚΗ ΕΝΟΤΗΤΑ ΒΟΡΕΙΟΥ ΤΟΜΕΑ ΑΘΗΝΩΝ";592490;277938;241136;1160;33028;206948;36802;314552
2;5147;"ΠΕΡΙΦΕΡΕΙΑΚΗ ΕΝΟΤΗΤΑ ΔΥΤΙΚΟΥ ΤΟΜΕΑ ΑΘΗΝΩΝ";489675;227400;182497;896;35884;145717;44903;262275
2;5148;"ΠΕΡΙΦΕΡΕΙΑΚΗ ΕΝΟΤΗΤΑ ΝΟΤΙΟΥ ΤΟΜΕΑ ΑΘΗΝΩΝ";529826;246253;205795;884;29579;175332;40458;283573
2;5149;"ΠΕΡΙΦΕΡΕΙΑΚΗ ΕΝΟΤΗΤΑ ΑΝΑΤΟΛΙΚΗΣ ΑΤΤΙΚΗΣ";502348;226409;188117;7552;37455;143110;38292;275939
2;5150;"ΠΕΡΙΦΕΡΕΙΑΚΗ ΕΝΟΤΗΤΑ ΔΥΤΙΚΗΣ ΑΤΤΙΚΗΣ";160927;69669;53515;2545;14963;36007;16154;91258
2;5151;"ΠΕΡΙΦΕΡΕΙΑΚΗ ΕΝΟΤΗΤΑ ΠΕΙΡΑΙΩΣ";448997;199030;157669;834;28268;128567;41361;249967
2;5152;"ΠΕΡΙΦΕΡΕΙΑΚΗ ΕΝΟΤΗΤΑ ΝΗΣΩΝ";74651;27246;21649;1829;3804;16016;5597;47405
2;6153;"ΠΕΡΙΦΕΡΕΙΑΚΗ ΕΝΟΤΗΤΑ ΛΕΣΒΟΥ";86436;32722;27909;4847;3916;19146;4813;53714
2;6154;"ΠΕΡΙΦΕΡΕΙΑΚΗ ΕΝΟΤΗΤΑ ΙΚΑΡΙΑΣ";9882;3704;3068;703;553;1812;636;6178
2;6155;"ΠΕΡΙΦΕΡΕΙΑΚΗ ΕΝΟΤΗΤΑ ΛΗΜΝΟΥ";17262;6843;5994;807;879;4308;849;10419
2;6156;"ΠΕΡΙΦΕΡΕΙΑΚΗ ΕΝΟΤΗΤΑ ΣΑΜΟΥ";32977;13213;11435;1215;1503;8717;1778;19764
2;6157;"ΠΕΡΙΦΕΡΕΙΑΚΗ ΕΝΟΤΗΤΑ ΧΙΟΥ";52674;20146;17503;1428;2809;13266;2643;32528
2;6258;"ΠΕΡΙΦΕΡΕΙΑΚΗ ΕΝΟΤΗΤΑ ΣΥΡΟΥ";21507;9034;7525;218;1538;5769;1509;12473
2;6259;"ΠΕΡΙΦΕΡΕΙΑΚΗ ΕΝΟΤΗΤΑ ΑΝΔΡΟΥ";9221;3554;3093;479;831;1783;461;5667
2;6260;"ΠΕΡΙΦΕΡΕΙΑΚΗ ΕΝΟΤΗΤΑ ΘΗΡΑΣ";18883;9211;8066;387;1416;6263;1145;9672
2;6261;"ΠΕΡΙΦΕΡΕΙΑΚΗ ΕΝΟΤΗΤΑ ΚΑΛΥΜΝΟΥ";29452;11255;9384;861;1778;6745;1871;18197
2;6262;"ΠΕΡΙΦΕΡΕΙΑΚΗ ΕΝΟΤΗΤΑ ΚΑΡΠΑΘΟΥ";7310;3078;2572;218;453;1901;506;4232
2;6263;"ΠΕΡΙΦΕΡΕΙΑΚΗ ΕΝΟΤΗΤΑ ΚΕΑΣ - ΚΥΘΝΟΥ";3911;1587;1447;274;416;757;140;2324
2;6264;"ΠΕΡΙΦΕΡΕΙΑΚΗ ΕΝΟΤΗΤΑ ΚΩ";34396;17732;15684;446;1633;13605;2048;16664
2;6265;"ΠΕΡΙΦΕΡΕΙΑΚΗ ΕΝΟΤΗΤΑ ΜΗΛΟΥ";9932;3709;3376;204;1002;2170;333;6223
2;6266;"ΠΕΡΙΦΕΡΕΙΑΚΗ ΕΝΟΤΗΤΑ ΜΥΚΟΝΟΥ";10134;5555;4943;135;1006;3802;612;4579
2;6267;"ΠΕΡΙΦΕΡΕΙΑΚΗ ΕΝΟΤΗΤΑ ΝΑΞΟΥ";20877;8614;7308;1019;1577;4712;1306;12263
2;6268;"ΠΕΡΙΦΕΡΕΙΑΚΗ ΕΝΟΤΗΤΑ ΠΑΡΟΥ";14926;6537;5771;383;1456;3932;766;8389
2;6269;"ΠΕΡΙΦΕΡΕΙΑΚΗ ΕΝΟΤΗΤΑ ΡΟΔΟΥ";119830;56486;48617;1396;6665;40556;7869;63344
2;6270;"ΠΕΡΙΦΕΡΕΙΑΚΗ ΕΝΟΤΗΤΑ ΤΗΝΟΥ";8636;3664;3164;225;829;2110;500;4972
2;7171;"ΠΕΡΙΦΕΡΕΙΑΚΗ ΕΝΟΤΗΤΑ ΗΡΑΚΛΕΙΟΥ";305490;133666;109627;14660;16642;78325;24039;171824
2;7172;"ΠΕΡΙΦΕΡΕΙΑΚΗ ΕΝΟΤΗΤΑ ΛΑΣΙΘΙΟΥ";75381;33005;28593;7015;3355;18223;4412;42376
2;7173;"ΠΕΡΙΦΕΡΕΙΑΚΗ ΕΝΟΤΗΤΑ ΡΕΘΥΜΝΟΥ";85609;35641;30499;5139;4358;21002;5142;49968
2;7174;"ΠΕΡΙΦΕΡΕΙΑΚΗ ΕΝΟΤΗΤΑ ΧΑΝΙΩΝ";156585;67561;56999;6444;8385;42170;10562;89024
3;110101;"ΔΗΜΟΣ ΚΟΜΟΤΗΝΗΣ";66919;25386;20631;2879;3187;14565;4755;41533
3;110102;"ΔΗΜΟΣ ΑΡΡΙΑΝΩΝ";16577;7232;6658;5532;368;758;574;9345
3;110103;"ΔΗΜΟΣ ΙΑΣΜΟΥ";13810;5377;4505;2695;661;1149;872;8433
3;110104;"ΔΗΜΟΣ ΜΑΡΩΝΕΙΑΣ - ΣΑΠΩΝ";14733;5018;4004;2074;674;1256;1014;9715
3;110201;"ΔΗΜΟΣ ΔΡΑΜΑΣ";58944;23530;18021;1308;3527;13186;5509;35414
3;110202;"ΔΗΜΟΣ ΔΟΞΑΤΟΥ";14516;5192;3810;890;803;2117;1382;9324
3;110203;"ΔΗΜΟΣ ΚΑΤΩ ΝΕΥΡΟΚΟΠΙΟΥ";7860;2687;2150;1111;288;751;537;5173
3;110204;"ΔΗΜΟΣ ΠΑΡΑΝΕΣΤΙΟΥ";3901;1088;808;271;147;390;280;2813
3;110205;"ΔΗΜΟΣ ΠΡΟΣΟΤΣΑΝΗΣ";13066;4223;3231;978;706;1547;992;8843
3;110301;"ΔΗΜΟΣ ΑΛΕΞΑΝΔΡΟΥΠΟΛΗΣ";72959;30219;25044;1897;3198;19949;5175;42740
3;110302;"ΔΗΜΟΣ ΔΙΔΥΜΟΤΕΙΧΟΥ";19493;6308;5334;1265;514;3555;974;13185
3;110303;"ΔΗΜΟΣ ΟΡΕΣΤΙΑΔΑΣ";37695;14599;12657;3348;1251;8058;1942;23096
".head()";110304;"ΔΗΜΟΣ ΣΑΜΟΘΡΑΚΗΣ";2859;1084;937;204;113;620;147;1775
3;110305;"ΔΗΜΟΣ ΣΟΥΦΛΙΟΥ";14941;5127;4471;1598;502;2371;656;9814
3;110401;"ΔΗΜΟΣ ΘΑΣΟΥ";13770;5468;4478;648;854;2976;990;8302
3;110501;"ΔΗΜΟΣ ΚΑΒΑΛΑΣ";70501;28020;22033;1185;4084;16764;5987;42481
3;110502;"ΔΗΜΟΣ ΝΕΣΤΟΥ";22331;8672;7060;2078;1362;3620;1612;13659
3;110503;"ΔΗΜΟΣ ΠΑΓΓΑΙΟΥ";32085;12090;9849;3173;1868;4808;2241;19995
3;110601;"ΔΗΜΟΣ ΞΑΝΘΗΣ";65133;26796;19989;830;3801;15358;6807;38337
3;110602;"ΔΗΜΟΣ ΑΒΔΗΡΩΝ";19005;7130;5014;1640;1229;2145;2116;11875
3;110603;"ΔΗΜΟΣ ΜΥΚΗΣ";15540;5395;3616;1743;1195;678;1779;10145
3;110604;"ΔΗΜΟΣ ΤΟΠΕΙΡΟΥ";11544;3938;3006;1440;560;1006;932;7606
3;120701;"ΔΗΜΟΣ ΘΕΣΣΑΛΟΝΙΚΗΣ";325182;134572;103243;877;15367;86999;31329;190610
3;120702;"ΔΗΜΟΣ ΑΜΠΕΛΟΚΗΠΩΝ - ΜΕΝΕΜΕΝΗΣ";52127;22258;15498;161;3691;11646;6760;29869
3;120703;"ΔΗΜΟΣ ΒΟΛΒΗΣ";23478;7602;6005;1695;1080;3230;1597;15876
3;120704;"ΔΗΜΟΣ ΔΕΛΤΑ";45839;18791;14263;1830;4588;7845;4528;27048
3;120705;"ΔΗΜΟΣ ΘΕΡΜΑΪΚΟΥ";50264;20747;16435;1160;2746;12529;4312;29517
3;120706;"ΔΗΜΟΣ ΘΕΡΜΗΣ";53201;23203;19743;1040;3393;15310;3460;29998
3;120707;"ΔΗΜΟΣ ΚΑΛΑΜΑΡΙΑΣ";91518;41998;34420;387;4555;29478;7578;49520
3;120708;"ΔΗΜΟΣ ΚΟΡΔΕΛΙΟΥ - ΕΥΟΣΜΟΥ";101753;48078;36421;352;8900;27169;11657;53675
3;120709;"ΔΗΜΟΣ ΛΑΓΚΑΔΑ";41103;15030;11589;1882;2831;6876;3441;26073
3;120710;"ΔΗΜΟΣ ΝΕΑΠΟΛΗΣ - ΣΥΚΕΩΝ";84741;37409;28301;227;5644;22430;9108;47332
3;120711;"ΔΗΜΟΣ ΠΑΥΛΟΥ ΜΕΛΑ";99245;45000;32621;343;7959;24319;12379;54245
3;120712;"ΔΗΜΟΣ ΠΥΛΑΙΑΣ - ΧΟΡΤΙΑΤΗ";70110;31980;27334;258;4209;22867;4646;38130
3;120713;"ΔΗΜΟΣ ΧΑΛΚΗΔΟΝΟΣ";33673;13150;10162;1705;2989;5468;2988;20523
3;120714;"ΔΗΜΟΣ ΩΡΑΙΟΚΑΣΤΡΟΥ";38317;16373;13357;555;3195;9607;3016;21944
3;120801;"ΔΗΜΟΣ ΒΕΡΟΙΑΣ";66547;27275;21275;3689;3672;13914;6000;39272
3;120802;"ΔΗΜΟΣ ΑΛΕΞΑΝΔΡΕΙΑΣ";41570;15801;12054;4201;2365;5488;3747;25769
3;120803;"ΔΗΜΟΣ ΝΑΟΥΣΑΣ";32494;12700;9774;2990;1704;5080;2926;19794
3;120901;"ΔΗΜΟΣ ΚΙΛΚΙΣ";51926;19734;15439;2336;4150;8953;4295;32192
3;120902;"ΔΗΜΟΣ ΠΑΙΟΝΙΑΣ";28493;9839;7547;1807;1735;4005;2292;18654
3;121001;"ΔΗΜΟΣ ΕΔΕΣΣΑΣ";28814;11230;9191;2387;1337;5467;2039;17584
3;121002;"ΔΗΜΟΣ ΑΛΜΩΠΙΑΣ";27556;10205;8505;3904;971;3630;1700;17351
3;121003;"ΔΗΜΟΣ ΠΕΛΛΑΣ";63122;25312;19917;5494;3605;10818;5395;37810
3;121004;"ΔΗΜΟΣ ΣΚΥΔΡΑΣ";20188;7835;6190;2578;1136;2476;1645;12353
3;121101;"ΔΗΜΟΣ ΚΑΤΕΡΙΝΗΣ";85851;34848;27504;4244;4487;18773;7344;51003
3;121102;"ΔΗΜΟΣ ΔΙΟΥ - ΟΛΥΜΠΟΥ";25668;9270;7558;1901;1346;4311;1712;16398
3;121103;"ΔΗΜΟΣ ΠΥΔΝΑΣ - ΚΟΛΙΝΔΡΟΥ";15179;5333;4362;1697;749;1916;971;9846
3;121201;"ΔΗΜΟΣ ΣΕΡΡΩΝ";76817;30106;24078;2743;3722;17613;6028;46711
3;121202;"ΔΗΜΟΣ ΑΜΦΙΠΟΛΗΣ";9182;2675;2080;916;237;927;595;6507
3;121203;"ΔΗΜΟΣ ΒΙΣΑΛΤΙΑΣ";20030;6795;5580;2740;758;2082;1215;13235
3;121204;"ΔΗΜΟΣ ΕΜΜΑΝΟΥΗΛ ΠΑΠΠΑ";14664;4969;3946;1499;726;1721;1023;9695
3;121205;"ΔΗΜΟΣ ΗΡΑΚΛΕΙΑΣ";21145;7220;5434;2437;722;2275;1786;13925
3;121206;"ΔΗΜΟΣ ΝΕΑΣ ΖΙΧΝΗΣ";12397;4246;3611;1953;356;1302;635;8151
3;121207;"ΔΗΜΟΣ ΣΙΝΤΙΚΗΣ";22195;7046;5247;1863;718;2666;1799;15149
3;121301;"ΔΗΜΟΣ ΠΟΛΥΓΥΡΟΥ";22048;8764;7394;1683;1444;4267;1370;13284
3;121303;"ΔΗΜΟΣ ΚΑΣΣΑΝΔΡΑΣ";16672;7309;5825;522;1035;4268;1484;9363
3;121304;"ΔΗΜΟΣ ΝΕΑΣ ΠΡΟΠΟΝΤΙΔΑΣ";36500;14804;11763;2268;2508;6987;3041;21696
3;121305;"ΔΗΜΟΣ ΣΙΘΩΝΙΑΣ";12394;5205;4162;665;628;2869;1043;7189
3;211401;"ΔΗΜΟΣ ΚΟΖΑΝΗΣ";71388;28015;21631;1103;6138;14390;6384;43373
3;211402;"ΔΗΜΟΣ ΒΟΪΟΥ";18386;6474;4815;1030;1360;2425;1659;11912
3;211403;"ΔΗΜΟΣ ΕΟΡΔΑΙΑΣ";45592;16931;13318;718;4970;7630;3613;28661
3;211404;"ΔΗΜΟΣ ΣΕΡΒΙΩΝ - ΒΕΛΒΕΝΤΟΥ";14830;4933;3732;982;904;1846;1201;9897
3;211501;"ΔΗΜΟΣ ΓΡΕΒΕΝΩΝ";25905;8860;7140;1298;1239;4603;1720;17045
3;211502;"ΔΗΜΟΣ ΔΕΣΚΑΤΗΣ";5852;1975;1533;594;193;746;442;3877
3;211601;"ΔΗΜΟΣ ΚΑΣΤΟΡΙΑΣ";35874;15412;11573;2057;2492;7024;3839;20462
3;211602;"ΔΗΜΟΣ ΝΕΣΤΟΡΙΟΥ";2646;968;691;221;136;334;277;1678
3;211603;"ΔΗΜΟΣ ΟΡΕΣΤΙΔΟΣ";11802;4886;3743;749;816;2178;1143;6916
3;211701;"ΔΗΜΟΣ ΦΛΩΡΙΝΑΣ";32881;12767;9960;1429;2075;6456;2807;20114
3;211702;"ΔΗΜΟΣ ΑΜΥΝΤΑΙΟΥ";16973;6248;4853;1280;1349;2224;1395;10725
3;211703;"ΔΗΜΟΣ ΠΡΕΣΠΩΝ";1560;625;541;331;25;185;84;935
3;221801;"ΔΗΜΟΣ ΙΩΑΝΝΙΤΩΝ";112486;47545;39287;1676;7091;30520;8258;64941
3;221802;"ΔΗΜΟΣ ΒΟΡΕΙΩΝ ΤΖΟΥΜΕΡΚΩΝ";5714;1751;1518;273;346;899;233;3963
3;221803;"ΔΗΜΟΣ ΔΩΔΩΝΗΣ";9693;3005;2490;591;502;1397;515;6688
3;221804;"ΔΗΜΟΣ ΖΑΓΟΡΙΟΥ";3724;1312;1147;357;185;605;165;2412
3;221805;"ΔΗΜΟΣ ΖΙΤΣΑΣ";14766;5845;4704;799;1126;2779;1141;8921
3;221806;"ΔΗΜΟΣ ΚΟΝΙΤΣΑΣ";6362;2031;1684;346;358;980;347;4331
3;221807;"ΔΗΜΟΣ ΜΕΤΣΟΒΟΥ";6196;2107;1686;384;440;862;421;4089
3;221808;"ΔΗΜΟΣ ΠΩΓΩΝΙΟΥ";8960;2766;2138;620;458;1060;628;6194
3;221901;"ΔΗΜΟΣ ΑΡΤΑΙΩΝ";43166;16782;13584;2245;2362;8977;3198;26384
3;221902;"ΔΗΜΟΣ ΓΕΩΡΓΙΟΥ ΚΑΡΑΪΣΚΑΚΗ";5780;1578;1216;498;194;524;362;4202
3;221903;"ΔΗΜΟΣ ΚΕΝΤΡΙΚΩΝ ΤΖΟΥΜΕΡΚΩΝ";6178;1448;1149;339;302;508;299;4730
3;221904;"ΔΗΜΟΣ ΝΙΚΟΛΑΟΥ ΣΚΟΥΦΑ";12753;4333;3489;1186;564;1739;844;8420
3;222001;"ΔΗΜΟΣ ΗΓΟΥΜΕΝΙΤΣΑΣ";25814;10890;8774;1028;1323;6423;2116;14924
3;222002;"ΔΗΜΟΣ ΣΟΥΛΙΟΥ";10063;3649;2979;894;520;1565;670;6414
3;222003;"ΔΗΜΟΣ ΦΙΛΙΑΤΩΝ";7710;2700;2230;942;293;995;470;5010
3;222101;"ΔΗΜΟΣ ΠΡΕΒΕΖΑΣ";31733;12717;10509;1773;1591;7145;2208;19016
3;222102;"ΔΗΜΟΣ ΖΗΡΟΥ";13892;4725;3707;859;708;2140;1018;9167
3;222103;"ΔΗΜΟΣ ΠΑΡΓΑΣ";11866;4528;3762;1192;498;2072;766;7338
3;312201;"ΔΗΜΟΣ ΛΑΡΙΣΑΙΩΝ";162591;68899;56186;3077;9698;43411;12713;93692
3;312202;"ΔΗΜΟΣ ΑΓΙΑΣ";11470;3883;3346;1543;406;1397;537;7587
3;312203;"ΔΗΜΟΣ ΕΛΑΣΣΟΝΑΣ";32121;10902;9066;3686;1392;3988;1836;21219
3;312204;"ΔΗΜΟΣ ΚΙΛΕΛΕΡ";20854;7996;6690;2525;998;3167;1306;12858
3;312205;"ΔΗΜΟΣ ΤΕΜΠΩΝ";13712;4508;3751;1184;820;1747;757;9204
3;312206;"ΔΗΜΟΣ ΤΥΡΝΑΒΟΥ";25032;9743;8185;2855;1449;3881;1558;15289
3;312207;"ΔΗΜΟΣ ΦΑΡΣΑΛΩΝ";18545;6591;5489;2352;799;2338;1102;11954
3;312301;"ΔΗΜΟΣ ΚΑΡΔΙΤΣΑΣ";56747;22536;17889;2242;2805;12842;4647;34211
3;312302;"ΔΗΜΟΣ ΑΡΓΙΘΕΑΣ";3450;802;572;206;123;243;230;2648
3;312303;"ΔΗΜΟΣ ΛΙΜΝΗΣ ΠΛΑΣΤΗΡΑ";4635;1156;956;220;175;561;200;3479
3;312304;"ΔΗΜΟΣ ΜΟΥΖΑΚΙΟΥ";13122;4230;3322;1244;520;1558;908;8892
3;312305;"ΔΗΜΟΣ ΠΑΛΑΜΑ";16726;6455;5492;3076;499;1917;963;10271
3;312306;"ΔΗΜΟΣ ΣΟΦΑΔΩΝ";18864;6242;4793;2524;474;1795;1449;12622
3;312401;"ΔΗΜΟΣ ΒΟΛΟΥ";144449;57685;46119;2167;9700;34252;11566;86764
3;312402;"ΔΗΜΟΣ ΑΛΜΥΡΟΥ";18614;6891;5801;1748;1143;2910;1090;11723
3;312403;"ΔΗΜΟΣ ΖΑΓΟΡΑΣ - ΜΟΥΡΕΣΙΟΥ";5809;2271;2047;1052;269;726;224;3538
3;312404;"ΔΗΜΟΣ ΝΟΤΙΟΥ ΠΗΛΙΟΥ";10216;3592;3080;1160;540;1380;512;6624
3;312405;"ΔΗΜΟΣ ΡΗΓΑ ΦΕΡΑΙΟΥ";10922;4087;3297;1109;661;1527;790;6835
3;312501;"ΔΗΜΟΣ ΣΚΙΑΘΟΥ";6088;2984;2551;74;358;2119;433;3104
3;312502;"ΔΗΜΟΣ ΑΛΟΝΝΗΣΟΥ";2750;973;791;98;193;500;182;1777
3;312503;"ΔΗΜΟΣ ΣΚΟΠΕΛΟΥ";4960;1879;1600;143;339;1118;279;3081
3;312601;"ΔΗΜΟΣ ΤΡΙΚΚΑΙΩΝ";81355;32323;25972;3127;4496;18349;6351;49032
3;312602;"ΔΗΜΟΣ ΚΑΛΑΜΠΑΚΑΣ";21991;7217;5754;1570;1061;3123;1463;14774
3;312603;"ΔΗΜΟΣ ΠΥΛΗΣ";14343;4882;3743;1100;751;1892;1139;9461
3;312604;"ΔΗΜΟΣ ΦΑΡΚΑΔΟΝΑΣ";13396;4700;3913;1872;682;1359;787;8696
3;322701;"ΔΗΜΟΣ ΛΑΜΙΕΩΝ";75315;30266;24326;2267;4562;17497;5940;45049
3;322702;"ΔΗΜΟΣ ΑΜΦΙΚΛΕΙΑΣ - ΕΛΑΤΕΙΑΣ";10922;4071;3408;1246;521;1641;663;6851
3;322703;"ΔΗΜΟΣ ΔΟΜΟΚΟΥ";11495;4158;3673;1807;433;1433;485;7337
3;322704;"ΔΗΜΟΣ ΛΟΚΡΩΝ";19623;7440;6297;1736;1699;2862;1143;12183
3;322705;"ΔΗΜΟΣ ΜΑΚΡΑΚΩΜΗΣ";16036;5245;3988;976;785;2227;1257;10791
3;322706;"ΔΗΜΟΣ ΜΩΛΟΥ - ΑΓΙΟΥ ΚΩΝΣΤΑΝΤΙΝΟΥ";12090;4479;3655;1023;593;2039;824;7611
3;322707;"ΔΗΜΟΣ ΣΤΥΛΙΔΟΣ";12750;4876;3975;1334;725;1916;901;7874
3;322801;"ΔΗΜΟΣ ΛΕΒΑΔΕΩΝ";31315;13088;10673;1259;2539;6875;2415;18227
3;322802;"ΔΗΜΟΣ ΑΛΙΑΡΤΟΥ";10887;4711;3706;1046;934;1726;1005;6176
3;322803;"ΔΗΜΟΣ ΔΙΣΤΟΜΟΥ - ΑΡΑΧΟΒΑΣ - ΑΝΤΙΚΥΡΑΣ";8188;3269;2693;151;1083;1459;576;4919
3;322804;"ΔΗΜΟΣ ΘΗΒΑΙΩΝ";36477;16356;13695;3519;3513;6663;2661;20121
3;322805;"ΔΗΜΟΣ ΟΡΧΟΜΕΝΟΥ";11621;4540;3691;1586;685;1420;849;7081
3;322806;"ΔΗΜΟΣ ΤΑΝΑΓΡΑΣ";19432;9074;7627;1406;2980;3241;1447;10358
3;322901;"ΔΗΜΟΣ ΧΑΛΚΙΔΕΩΝ";102223;45268;36391;2499;10367;23525;8877;56955
3;322902;"ΔΗΜΟΣ ΔΙΡΦΥΩΝ - ΜΕΣΣΑΠΙΩΝ";18800;7523;6067;1600;1700;2767;1456;11277
3;322903;"ΔΗΜΟΣ ΕΡΕΤΡΙΑΣ";13053;5032;3877;364;1080;2433;1155;8021
3;322904;"ΔΗΜΟΣ ΙΣΤΙΑΙΑΣ - ΑΙΔΗΨΟΥ";21083;7739;6242;1440;1085;3717;1497;13344
3;322905;"ΔΗΜΟΣ ΚΑΡΥΣΤΟΥ";12180;4358;3605;759;815;2031;753;7822
3;322906;"ΔΗΜΟΣ ΚΥΜΗΣ - ΑΛΙΒΕΡΙΟΥ";28437;9432;7722;974;2305;4443;1710;19005
3;322907;"ΔΗΜΟΣ ΜΑΝΤΟΥΔΙΟΥ - ΛΙΜΝΗΣ - ΑΓΙΑΣ ΑΝΝΑΣ";12045;4237;3032;602;709;1721;1205;7808
3;322908;"ΔΗΜΟΣ ΣΚΥΡΟΥ";2994;1202;1054;135;166;753;148;1792
3;323001;"ΔΗΜΟΣ ΚΑΡΠΕΝΗΣΙΟΥ";13105;4760;3715;467;661;2587;1045;8345
3;323002;"ΔΗΜΟΣ ΑΓΡΑΦΩΝ";6976;1941;1396;614;243;539;545;5035
3;323101;"ΔΗΜΟΣ ΔΕΛΦΩΝ";26716;10273;8378;1016;1675;5687;1895;16443
3;323102;"ΔΗΜΟΣ ΔΩΡΙΔΟΣ";13627;3940;3086;669;605;1812;854;9687
3;413201;"ΔΗΜΟΣ ΚΕΡΚΥΡΑΣ";102071;43773;35594;2374;4655;28565;8179;58298
3;413202;"ΔΗΜΟΣ ΠΑΞΩΝ";2300;989;883;136;132;615;106;1311
3;413301;"ΔΗΜΟΣ ΖΑΚΥΝΘΟΥ";40759;18271;15206;2158;1911;11137;3065;22488
3;413401;"ΔΗΜΟΣ ΙΘΑΚΗΣ";3231;1233;1081;122;234;725;152;1998
3;413501;"ΔΗΜΟΣ ΚΕΦΑΛΟΝΙΑΣ";35801;14762;12445;1303;2158;8984;2317;21039
3;413601;"ΔΗΜΟΣ ΛΕΥΚΑΔΑΣ";22652;9346;7863;770;1447;5646;1483;13306
3;413602;"ΔΗΜΟΣ ΜΕΓΑΝΗΣΙΟΥ";1041;319;278;35;37;206;41;722
3;423701;"ΔΗΜΟΣ ΠΑΤΡΕΩΝ";213984;87763;68820;1477;11899;55444;18943;126221
3;423702;"ΔΗΜΟΣ ΑΙΓΙΑΛΕΙΑΣ";49872;19398;15515;3107;2941;9467;3883;30474
3;423703;"ΔΗΜΟΣ ΔΥΤΙΚΗΣ ΑΧΑΪΑΣ";25916;8956;7033;2340;1145;3548;1923;16960
3;423704;"ΔΗΜΟΣ ΕΡΥΜΑΝΘΟΥ";8877;3194;2625;1130;438;1057;569;5683
3;423705;"ΔΗΜΟΣ ΚΑΛΑΒΡΥΤΩΝ";11045;3619;3041;999;502;1540;578;7426
3;423801;"ΔΗΜΟΣ ΙΕΡΑΣ ΠΟΛΗΣ ΜΕΣΟΛΟΓΓΙΟΥ";34416;12492;9948;3070;1397;5481;2544;21924
3;423802;"ΔΗΜΟΣ ΑΚΤΙΟΥ - ΒΟΝΙΤΣΑΣ";17370;6032;4905;2038;820;2047;1127;11338
3;423803;"ΔΗΜΟΣ ΑΓΡΙΝΙΟΥ";94181;35539;27172;4793;4327;18052;8367;58642
3;423804;"ΔΗΜΟΣ ΑΜΦΙΛΟΧΙΑΣ";17056;5654;4549;1937;659;1953;1105;11402
3;423805;"ΔΗΜΟΣ ΘΕΡΜΟΥ";8242;2543;2078;594;390;1094;465;5699
3;423806;"ΔΗΜΟΣ ΝΑΥΠΑΚΤΙΑΣ";27800;9982;7774;965;1610;5199;2208;17818
3;423807;"ΔΗΜΟΣ ΞΗΡΟΜΕΡΟΥ";11737;4129;3312;1939;288;1085;817;7608
3;423901;"ΔΗΜΟΣ ΠΥΡΓΟΥ";47995;18469;14652;2699;2177;9776;3817;29526
3;423902;"ΔΗΜΟΣ ΗΛΙΔΑΣ";32219;12889;10136;2788;1843;5505;2753;19330
3;423903;"ΔΗΜΟΣ ΑΝΔΡΑΒΙΔΑΣ - ΚΥΛΛΗΝΗΣ";21581;9261;7894;3590;884;3420;1367;12320
3;423904;"ΔΗΜΟΣ ΑΝΔΡΙΤΣΑΙΝΑΣ - ΚΡΕΣΤΕΝΩΝ";14109;4949;3769;1632;542;1595;1180;9160
3;423905;"ΔΗΜΟΣ ΑΡΧΑΙΑΣ ΟΛΥΜΠΙΑΣ";13409;4555;3714;1214;468;2032;841;8854
3;423906;"ΔΗΜΟΣ ΖΑΧΑΡΩΣ";8953;3152;2580;963;369;1248;572;5801
3;423907;"ΔΗΜΟΣ ΠΗΝΕΙΟΥ";21034;8599;6826;2973;980;2873;1773;12435
3;434001;"ΔΗΜΟΣ ΤΡΙΠΟΛΗΣ";47254;19837;17068;2299;3398;11371;2769;27417
3;434002;"ΔΗΜΟΣ ΒΟΡΕΙΑΣ ΚΥΝΟΥΡΙΑΣ";10341;3895;3214;815;624;1775;681;6446
3;434003;"ΔΗΜΟΣ ΓΟΡΤΥΝΙΑΣ";10109;2677;2172;675;468;1029;505;7432
3;434004;"ΔΗΜΟΣ ΜΕΓΑΛΟΠΟΛΗΣ";10687;3735;3097;254;1338;1505;638;6952
3;434005;"ΔΗΜΟΣ ΝΟΤΙΑΣ ΚΥΝΟΥΡΙΑΣ";8294;3184;2685;1027;427;1231;499;5110
3;434101;"ΔΗΜΟΣ ΝΑΥΠΛΙΕΩΝ";33356;14327;12045;2283;1663;8099;2282;19029
3;434102;"ΔΗΜΟΣ ΑΡΓΟΥΣ - ΜΥΚΗΝΩΝ";42022;17605;14605;3917;2503;8185;3000;24417
3;434103;"ΔΗΜΟΣ ΕΠΙΔΑΥΡΟΥ";8115;3108;2713;1110;415;1188;395;5007
3;434104;"ΔΗΜΟΣ ΕΡΜΙΟΝΙΔΑΣ";13551;5676;4802;913;1203;2686;874;7875
3;434201;"ΔΗΜΟΣ ΚΟΡΙΝΘΙΩΝ";58192;24427;19965;2567;4436;12962;4462;33765
3;434202;"ΔΗΜΟΣ ΒΕΛΟΥ - ΒΟΧΑΣ";19027;8016;6672;2007;1109;3556;1344;11011
3;434203;"ΔΗΜΟΣ ΛΟΥΤΡΑΚΙΟΥ - ΑΓΙΩΝ ΘΕΟΔΩΡΩΝ";21221;8450;6751;297;1505;4949;1699;12771
3;434204;"ΔΗΜΟΣ ΝΕΜΕΑΣ";6483;2592;2280;1112;258;910;312;3891
3;434205;"ΔΗΜΟΣ ΞΥΛΟΚΑΣΤΡΟΥ - ΕΥΡΩΣΤΙΝΗΣ";17365;6776;5718;1813;811;3094;1058;10589
3;434206;"ΔΗΜΟΣ ΣΙΚΥΩΝΙΩΝ";22794;9611;8068;2724;1276;4068;1543;13183
3;434301;"ΔΗΜΟΣ ΣΠΑΡΤΗΣ";35259;13900;11879;2865;1777;7237;2021;21359
3;434302;"ΔΗΜΟΣ ΑΝΑΤΟΛΙΚΗΣ ΜΑΝΗΣ";13005;4821;4073;1349;564;2160;748;8184
3;434303;"ΔΗΜΟΣ ΕΛΑΦΟΝΗΣΟΥ";1041;433;366;84;42;240;67;608
3;434304;"ΔΗΜΟΣ ΕΥΡΩΤΑ";17891;7998;7192;4494;607;2091;806;9893
3;434305;"ΔΗΜΟΣ ΜΟΝΕΜΒΑΣΙΑΣ";21942;8571;7504;3298;961;3245;1067;13371
3;434401;"ΔΗΜΟΣ ΚΑΛΑΜΑΤΑΣ";69849;29749;23967;1746;4280;17941;5782;40100
3;434402;"ΔΗΜΟΣ ΔΥΤΙΚΗΣ ΜΑΝΗΣ";6945;2439;2160;742;371;1047;279;4506
3;434403;"ΔΗΜΟΣ ΜΕΣΣΗΝΗΣ";23482;8397;7050;2762;932;3356;1347;15085
3;434404;"ΔΗΜΟΣ ΟΙΧΑΛΙΑΣ";11228;3632;2996;991;524;1481;636;7596
3;434405;"ΔΗΜΟΣ ΠΥΛΟΥ - ΝΕΣΤΟΡΟΣ";21077;7925;6981;3140;925;2916;944;13152
3;434406;"ΔΗΜΟΣ ΤΡΙΦΥΛΙΑΣ";27373;12205;10738;5155;1323;4260;1467;15168
3;514501;"ΔΗΜΟΣ ΑΘΗΝΑΙΩΝ";664046;327389;260658;1273;42683;216702;66731;336657
3;514502;"ΔΗΜΟΣ ΒΥΡΩΝΟΣ";61308;28423;23679;81;3474;20124;4744;32885
3;514503;"ΔΗΜΟΣ ΓΑΛΑΤΣΙΟΥ";59345;28276;23395;115;3762;19518;4881;31069
3;514504;"ΔΗΜΟΣ ΔΑΦΝΗΣ - ΥΜΗΤΤΟΥ";33628;15877;13017;42;2067;10908;2860;17751
3;514505;"ΔΗΜΟΣ ΖΩΓΡΑΦΟΥ";71026;31956;26546;93;3173;23280;5410;39070
3;514506;"ΔΗΜΟΣ ΗΛΙΟΥΠΟΛΕΩΣ";78153;36410;30527;124;4519;25884;5883;41743
3;514507;"ΔΗΜΟΣ ΚΑΙΣΑΡΙΑΝΗΣ";26458;12431;10287;25;1378;8884;2144;14027
3;514508;"ΔΗΜΟΣ ΦΙΛΑΔΕΛΦΕΙΑΣ - ΧΑΛΚΗΔΟΝΟΣ";35556;16855;13716;75;2524;11117;3139;18701
3;514601;"ΔΗΜΟΣ ΑΜΑΡΟΥΣΙΟΥ";72333;34143;29960;139;3794;26027;4183;38190
3;514602;"ΔΗΜΟΣ ΑΓΙΑΣ ΠΑΡΑΣΚΕΥΗΣ";59704;28166;24581;76;2798;21707;3585;31538
3;514603;"ΔΗΜΟΣ ΒΡΙΛΗΣΣΙΩΝ";30741;14376;12861;60;1586;11215;1515;16365
3;514604;"ΔΗΜΟΣ ΗΡΑΚΛΕΙΟΥ";49642;23824;20251;87;3335;16829;3573;25818
3;514605;"ΔΗΜΟΣ ΚΗΦΙΣΙΑΣ";71259;32282;28790;217;4011;24562;3492;38977
3;514606;"ΔΗΜΟΣ ΛΥΚΟΒΡΥΣΗΣ - ΠΕΥΚΗΣ";31153;14651;12663;76;1996;10591;1988;16502
3;514607;"ΔΗΜΟΣ ΜΕΤΑΜΟΡΦΩΣΕΩΣ";29891;14585;12170;81;2528;9561;2415;15306
3;514608;"ΔΗΜΟΣ ΝΕΑΣ ΙΩΝΙΑΣ";67134;32465;26325;127;4685;21513;6140;34669
3;514609;"ΔΗΜΟΣ ΠΑΠΑΓΟΥ - ΧΟΛΑΡΓΟΥ";44539;19773;17492;54;1778;15660;2281;24766
3;514610;"ΔΗΜΟΣ ΠΕΝΤΕΛΗΣ";34934;16470;14447;67;1891;12489;2023;18464
3;514611;"ΔΗΜΟΣ ΦΙΛΟΘΕΗΣ - ΨΥΧΙΚΟΥ";26968;12357;11267;45;1087;10135;1090;14611
3;514612;"ΔΗΜΟΣ ΧΑΛΑΝΔΡΙΟΥ";74192;34846;30329;131;3539;26659;4517;39346
3;514701;"ΔΗΜΟΣ ΠΕΡΙΣΤΕΡΙΟΥ";139981;65847;52316;257;10581;41478;13531;74134
3;514702;"ΔΗΜΟΣ ΑΓΙΑΣ ΒΑΡΒΑΡΑΣ";26550;11277;8503;35;1620;6848;2774;15273
3;514703;"ΔΗΜΟΣ ΑΓΙΩΝ ΑΝΑΡΓΥΡΩΝ - ΚΑΜΑΤΕΡΟΥ";62529;29390;23870;116;5186;18568;5520;33139
3;514704;"ΔΗΜΟΣ ΑΙΓΑΛΕΩ";69946;31877;24825;157;4749;19919;7052;38069
3;514705;"ΔΗΜΟΣ ΙΛΙΟΥ";84793;39469;31711;155;6673;24883;7758;45324
3;514706;"ΔΗΜΟΣ ΠΕΤΡΟΥΠΟΛΕΩΣ";58979;28322;23550;93;4137;19320;4772;30657
3;514707;"ΔΗΜΟΣ ΧΑΪΔΑΡΙΟΥ";46897;21218;17722;83;2938;14701;3496;25679
3;514801;"ΔΗΜΟΣ ΚΑΛΛΙΘΕΑΣ";100641;46707;37371;168;5665;31538;9336;53934
3;514802;"ΔΗΜΟΣ ΑΓΙΟΥ ΔΗΜΗΤΡΙΟΥ";71294;34137;28261;145;5013;23103;5876;37157
3;514803;"ΔΗΜΟΣ ΑΛΙΜΟΥ";41720;19262;16653;60;2181;14412;2609;22458
3;514804;"ΔΗΜΟΣ ΓΛΥΦΑΔΑΣ";87305;39814;34153;158;4486;29509;5661;47491
3;514805;"ΔΗΜΟΣ ΕΛΛΗΝΙΚΟΥ - ΑΡΓΥΡΟΥΠΟΛΗΣ";51356;23539;19979;79;3018;16882;3560;27817
3;514806;"ΔΗΜΟΣ ΜΟΣΧΑΤΟΥ - ΤΑΥΡΟΥ";40413;19394;15579;78;2761;12740;3815;21019
3;514807;"ΔΗΜΟΣ ΝΕΑΣ ΣΜΥΡΝΗΣ";73076;34518;29303;79;3394;25830;5215;38558
3;514808;"ΔΗΜΟΣ ΠΑΛΑΙΟΥ ΦΑΛΗΡΟΥ";64021;28882;24496;117;3061;21318;4386;35139
3;514901;"ΔΗΜΟΣ ΑΧΑΡΝΩΝ";106943;49730;38480;534;9606;28340;11250;57213
3;514902;"ΔΗΜΟΣ ΒΑΡΗΣ - ΒΟΥΛΑΣ - ΒΟΥΛΙΑΓΜΕΝΗΣ";48399;21152;18568;159;2286;16123;2584;27247
3;514903;"ΔΗΜΟΣ ΔΙΟΝΥΣΟΥ";40193;18598;16530;127;2884;13519;2068;21595
3;514904;"ΔΗΜΟΣ ΚΡΩΠΙΑΣ";30307;13723;11225;447;2911;7867;2498;16584
3;514905;"ΔΗΜΟΣ ΛΑΥΡΕΩΤΙΚΗΣ";25102;10192;7747;229;1918;5600;2445;14910
3;514906;"ΔΗΜΟΣ ΜΑΡΑΘΩΝΟΣ";33423;16538;13953;3864;2154;7935;2585;16885
3;514907;"ΔΗΜΟΣ ΜΑΡΚΟΠΟΥΛΟΥ ΜΕΣΟΓΑΙΑΣ";20040;8674;7354;250;1484;5620;1320;11366
3;514908;"ΔΗΜΟΣ ΠΑΙΑΝΙΑΣ";26668;12657;10768;297;2149;8322;1889;14011
3;514909;"ΔΗΜΟΣ ΠΑΛΛΗΝΗΣ";54415;27154;23569;131;3943;19495;3585;27261
3;514910;"ΔΗΜΟΣ ΡΑΦΗΝΑΣ - ΠΙΚΕΡΜΙΟΥ";20266;9128;7920;93;1286;6541;1208;11138
3;514911;"ΔΗΜΟΣ ΣΑΡΩΝΙΚΟΥ";29002;12078;9980;294;1874;7812;2098;16924
3;514912;"ΔΗΜΟΣ ΣΠΑΤΩΝ - ΑΡΤΕΜΙΔΟΣ";33821;14442;11763;299;2429;9035;2679;19379
3;514913;"ΔΗΜΟΣ ΩΡΩΠΟΥ";33769;12343;10260;828;2531;6901;2083;21426
3;515001;"ΔΗΜΟΣ ΕΛΕΥΣΙΝΑΣ";29902;13701;11064;126;3361;7577;2637;16201
3;515002;"ΔΗΜΟΣ ΑΣΠΡΟΠΥΡΓΟΥ";30251;13187;9341;341;3248;5752;3846;17064
3;515003;"ΔΗΜΟΣ ΜΑΝΔΡΑΣ - ΕΙΔΥΛΛΙΑΣ";17885;7369;5995;320;1785;3890;1374;10516
3;515004;"ΔΗΜΟΣ ΜΕΓΑΡΕΩΝ";36924;15059;11694;1621;2920;7153;3365;21865
3;515005;"ΔΗΜΟΣ ΦΥΛΗΣ";45965;20353;15421;137;3649;11635;4932;25612
3;515101;"ΔΗΜΟΣ ΠΕΙΡΑΙΩΣ";163688;73551;59122;297;9215;49610;14429;90137
3;515102;"ΔΗΜΟΣ ΚΕΡΑΤΣΙΝΙΟΥ - ΔΡΑΠΕΤΣΩΝΑΣ";91045;39990;31842;175;5929;25738;8148;51055
3;515103;"ΔΗΜΟΣ ΚΟΡΥΔΑΛΛΟΥ";63445;26838;21351;86;3881;17384;5487;36607
3;515104;"ΔΗΜΟΣ ΝΙΚΑΙΑΣ - ΑΓΙΟΥ ΙΩΑΝΝΗ ΡΕΝΤΗ";105430;47393;37009;223;7546;29240;10384;58037
3;515105;"ΔΗΜΟΣ ΠΕΡΑΜΑΤΟΣ";25389;11258;8345;53;1697;6595;2913;14131
3;515201;"ΔΗΜΟΣ ΣΑΛΑΜΙΝΟΣ";39283;13546;10374;256;1795;8323;3172;25737
3;515202;"ΔΗΜΟΣ ΥΔΡΑΣ";1966;801;646;30;90;526;155;1165
3;515203;"ΔΗΜΟΣ ΑΓΚΙΣΤΡΙΟΥ";1142;425;363;10;70;283;62;717
3;515204;"ΔΗΜΟΣ ΑΙΓΙΝΑΣ";13056;5061;3963;246;786;2931;1098;7995
3;515205;"ΔΗΜΟΣ ΚΥΘΗΡΩΝ";4041;1616;1448;211;329;908;168;2425
3;515206;"ΔΗΜΟΣ ΠΟΡΟΥ";3993;1366;1163;108;115;940;203;2627
3;515207;"ΔΗΜΟΣ ΣΠΕΤΣΩΝ";4027;1651;1347;57;292;998;304;2376
3;515208;"ΔΗΜΟΣ ΤΡΟΙΖΗΝΙΑΣ";7143;2780;2345;911;327;1107;435;4363
3;615301;"ΔΗΜΟΣ ΛΕΣΒΟΥ";86436;32722;27909;4847;3916;19146;4813;53714
3;615401;"ΔΗΜΟΣ ΙΚΑΡΙΑΣ";8423;3276;2736;673;504;1559;540;5147
3;615402;"ΔΗΜΟΣ ΦΟΥΡΝΩΝ ΚΟΡΣΕΩΝ";1459;428;332;30;49;253;96;1031
3;615501;"ΔΗΜΟΣ ΛΗΜΝΟΥ";16992;6756;5915;781;866;4268;841;10236
3;615502;"ΔΗΜΟΣ ΑΓΙΟΥ ΕΥΣΤΡΑΤΙΟΥ";270;87;79;26;13;40;8;183
3;615601;"ΔΗΜΟΣ ΣΑΜΟΥ";32977;13213;11435;1215;1503;8717;1778;19764
3;615701;"ΔΗΜΟΣ ΧΙΟΥ";51390;19744;17154;1386;2758;13010;2590;31646
3;615702;"ΔΗΜΟΣ ΟΙΝΟΥΣΣΩΝ";826;243;219;26;38;155;24;583
3;615703;"ΔΗΜΟΣ ΨΑΡΩΝ";458;159;130;16;13;101;29;299
3;625801;"ΔΗΜΟΣ ΣΥΡΟΥ - ΕΡΜΟΥΠΟΛΗΣ";21507;9034;7525;218;1538;5769;1509;12473
3;625901;"ΔΗΜΟΣ ΑΝΔΡΟΥ";9221;3554;3093;479;831;1783;461;5667
3;626001;"ΔΗΜΟΣ ΘΗΡΑΣ";15550;7667;6687;236;1121;5330;980;7883
3;626002;"ΔΗΜΟΣ ΑΝΑΦΗΣ";271;111;99;28;16;55;12;160
3;626003;"ΔΗΜΟΣ ΙΗΤΩΝ";2024;986;880;73;187;620;106;1038
3;626004;"ΔΗΜΟΣ ΣΙΚΙΝΟΥ";273;101;86;15;18;53;15;172
3;626005;"ΔΗΜΟΣ ΦΟΛΕΓΑΝΔΡΟΥ";765;346;314;35;74;205;32;419
3;626101;"ΔΗΜΟΣ ΚΑΛΥΜΝΙΩΝ";16179;5881;4754;499;942;3313;1127;10298
3;626102;"ΔΗΜΟΣ ΑΓΑΘΟΝΗΣΙΟΥ";185;87;75;24;8;43;12;98
3;626103;"ΔΗΜΟΣ ΑΣΤΥΠΑΛΑΙΑΣ";1334;516;438;62;120;256;78;818
3;626104;"ΔΗΜΟΣ ΛΕΙΨΩΝ";790;321;285;37;57;191;36;469
3;626105;"ΔΗΜΟΣ ΛΕΡΟΥ";7917;3113;2632;169;385;2078;481;4804
3;626106;"ΔΗΜΟΣ ΠΑΤΜΟΥ";3047;1337;1200;70;266;864;137;1710
3;626201;"ΔΗΜΟΣ ΚΑΡΠΑΘΟΥ";6226;2744;2305;177;398;1730;439;3482
3;626202;"ΔΗΜΟΣ ΚΑΣΟΥ";1084;334;267;41;55;171;67;750
3;626301;"ΔΗΜΟΣ ΚΕΑΣ";2455;988;896;143;272;481;92;1467
3;626302;"ΔΗΜΟΣ ΚΥΘΝΟΥ";1456;599;551;131;144;276;48;857
3;626401;"ΔΗΜΟΣ ΚΩ";33388;17291;15357;423;1556;13378;1934;16097
3;626402;"ΔΗΜΟΣ ΝΙΣΥΡΟΥ";1008;441;327;23;77;227;114;567
3;626501;"ΔΗΜΟΣ ΜΗΛΟΥ";4977;1965;1791;66;533;1192;174;3012
3;626502;"ΔΗΜΟΣ ΚΙΜΩΛΟΥ";910;219;199;21;71;107;20;691
3;626503;"ΔΗΜΟΣ ΣΕΡΙΦΟΥ";1420;543;484;43;144;297;59;877
3;626504;"ΔΗΜΟΣ ΣΙΦΝΟΥ";2625;982;902;74;254;574;80;1643
3;626601;"ΔΗΜΟΣ ΜΥΚΟΝΟΥ";10134;5555;4943;135;1006;3802;612;4579
3;626701;"ΔΗΜΟΣ ΑΜΟΡΓΟΥ";1973;825;737;120;157;460;88;1148
3;626702;"ΔΗΜΟΣ ΝΑΞΟΥ ΚΑΙ ΜΙΚΡΩΝ ΚΥΚΛΑΔΩΝ";18904;7789;6571;899;1420;4252;1218;11115
3;626801;"ΔΗΜΟΣ ΠΑΡΟΥ";13715;6081;5375;337;1375;3663;706;7634
3;626802;"ΔΗΜΟΣ ΑΝΤΙΠΑΡΟΥ";1211;456;396;46;81;269;60;755
3;626901;"ΔΗΜΟΣ ΡΟΔΟΥ";115490;54663;47009;1301;6343;39365;7654;60827
3;626902;"ΔΗΜΟΣ ΜΕΓΙΣΤΗΣ";492;213;199;14;49;136;14;279
3;626903;"ΔΗΜΟΣ ΣΥΜΗΣ";2590;1073;941;44;189;708;132;1517
3;626904;"ΔΗΜΟΣ ΤΗΛΟΥ";780;303;277;26;46;205;26;477
3;626905;"ΔΗΜΟΣ ΧΑΛΚΗΣ";478;234;191;11;38;142;43;244
3;627001;"ΔΗΜΟΣ ΤΗΝΟΥ";8636;3664;3164;225;829;2110;500;4972
3;717101;"ΔΗΜΟΣ ΗΡΑΚΛΕΙΟΥ";173993;79369;64269;2706;10136;51427;15100;94624
3;717102;"ΔΗΜΟΣ ΑΡΧΑΝΩΝ - ΑΣΤΕΡΟΥΣΙΩΝ";16692;6247;5361;1891;769;2701;886;10445
3;717103;"ΔΗΜΟΣ ΒΙΑΝΝΟΥ";5563;1993;1782;1007;132;643;211;3570
3;717104;"ΔΗΜΟΣ ΓΟΡΤΥΝΑΣ";15632;5321;4456;2183;600;1673;865;10311
3;717105;"ΔΗΜΟΣ ΜΑΛΕΒΙΖΙΟΥ";24864;11548;9439;956;1649;6834;2109;13316
3;717106;"ΔΗΜΟΣ ΜΙΝΩΑ ΠΕΔΙΑΔΑΣ";17563;6422;5124;1579;836;2709;1298;11141
3;717107;"ΔΗΜΟΣ ΦΑΙΣΤΟΥ";24466;10296;8885;3722;1188;3975;1411;14170
3;717108;"ΔΗΜΟΣ ΧΕΡΣΟΝΗΣΟΥ";26717;12470;10311;616;1332;8363;2159;14247
3;717201;"ΔΗΜΟΣ ΑΓΙΟΥ ΝΙΚΟΛΑΟΥ";27074;12074;10413;541;1376;8496;1661;15000
3;717202;"ΔΗΜΟΣ ΙΕΡΑΠΕΤΡΑΣ";27602;13030;11444;4731;1092;5621;1586;14572
3;717203;"ΔΗΜΟΣ ΟΡΟΠΕΔΙΟΥ ΛΑΣΙΘΙΟΥ";2387;808;744;356;62;326;64;1579
3;717204;"ΔΗΜΟΣ ΣΗΤΕΙΑΣ";18318;7093;5992;1387;825;3780;1101;11225
3;717301;"ΔΗΜΟΣ ΡΕΘΥΜΝΗΣ";55525;24582;20658;1416;3237;16005;3924;30943
3;717302;"ΔΗΜΟΣ ΑΓΙΟΥ ΒΑΣΙΛΕΙΟΥ";7427;2782;2477;817;237;1423;305;4645
3;717303;"ΔΗΜΟΣ ΑΜΑΡΙΟΥ";5915;2089;1787;676;207;904;302;3826
3;717304;"ΔΗΜΟΣ ΑΝΩΓΕΙΩΝ";2379;895;801;315;87;399;94;1484
3;717305;"ΔΗΜΟΣ ΜΥΛΟΠΟΤΑΜΟΥ";14363;5293;4776;1915;590;2271;517;9070
3;717401;"ΔΗΜΟΣ ΧΑΝΙΩΝ";108642;49424;41417;1460;6443;33514;8007;59218
3;717402;"ΔΗΜΟΣ ΑΠΟΚΟΡΩΝΟΥ";12807;4692;4006;819;607;2580;686;8115
3;717403;"ΔΗΜΟΣ ΓΑΥΔΟΥ";152;80;68;20;11;37;12;72
3;717404;"ΔΗΜΟΣ ΚΑΝΤΑΝΟΥ - ΣΕΛΙΝΟΥ";5431;2198;1925;908;165;852;273;3233
3;717405;"ΔΗΜΟΣ ΚΙΣΣΑΜΟΥ";10790;3950;3417;1217;521;1679;533;6840
3;717406;"ΔΗΜΟΣ ΠΛΑΤΑΝΙΑ";16874;6504;5532;1659;599;3274;972;10370
3;717407;"ΔΗΜΟΣ ΣΦΑΚΙΩΝ";1889;713;634;361;39;234;79;1176
